姜 还是 老的辣$一位 教|社会学的 老师$打了 个|幽默的 比喻 说
一千|四百 二十一 语丝$不惜|牺牲 自由$以图 苟安的 人
魏格登 先生$每听到|前门的 小铃$发出|轻微的|叮当声
法国 人民|深深 铭记着|将军$对 法兰西 民族的|丰功 伟绩
刚满 十五岁的|娜尔吉丝$即在 影片|命运中|担任了 主角
由于 这些|高级 职员|平时 受到|日本 堂倌的|特殊 照顾
反正|一年 到头|有 奶妈|和 梅香 丫头$陪她 在|花楼上|嬉戏
太空船|强力的 引擎|所耗 燃料 之巨$非 海上 船只 可比
专替 准备|放弃 婴儿的 孕妇|服务$我们|代办 一切
地球|曾经 发生过 许多次|大规模 火山$或 海底 温泉 活动
武家坪|等|周围 村镇$赶来 给|陈永贵|最后|送行的 群众
席上 红红 绿绿$有 鹿鞭$有 驼蹄$有 飞龙$还有野 凤凰
乘车 从|宁夏 首府 银川$赶往|内蒙古|伊克 昭盟
因而 在|印度 电影节$和|捷克 卡罗维|发利|国际 电影节 中
在 拍摄|印度 母亲 中$他 饰演|拉塔 儿子 逃跑的 一幕 时
原来|他母亲|在 怀孕|七个月时$想用 洗|热水 澡$使 胎儿 流产
不久|英国 海军 上将|威廉 但披尔$进行|私人 海洋 考察
每星期 为|该岛上|两个 村庄的 居民$每人|买 一块 面包
主办人 是 一群|不肯 在|官方 巴黎|沙龙|展出 作品的 朋友
里根 总统 和|布什 副总统$都没有 去 埃及$出席 萨达特的 葬礼
衡量|广告 吸引力的|另一种|新 技术$是用|电极|量度 脑波
要是|我的 收入$增加到 能|买的起|那几样|我 想买的 东西
又 看到 一幅|表现|野牛|被 猎人|用 扎枪|射死的 大壁画
然后|从|亨利 哈德逊|塑像 那里$沿着 雪坡|一直 溜到|大栅栏
接着|他又 反弹$或者 翻滚$越过了 一堵|混凝土 护土墙
请问 美国 医学界$对|这类 情况$是|采取|什么|治疗 方案
我们 男人|为何 仍$坚持 每天|照例 要 打这场|赢不了的 仗
并且|还 需要|更多的 人手$您就|尽管 吩咐|总司令 好了
屏息 凝望着 那|濒临 死亡的|溺水 少女$在|浪涛中|苦苦 挣扎
可是|我 对于 当|知识 分子|这个 行当$却|真有点|谈虎 色变
包括|人寿 保险$健康 保险$意外 伤害 保险|等|保险 业务
中国 女将|杨扬|杨阳|王春露$一举 囊括|金银铜|三块 奖牌
以|景点 开发$完善|促销 网络$改善|旅游 消费 环境|为 重点
桑帕约|首先 对|韩杼滨 率团|到|葡萄牙 访问$表示 欢迎
今年 被|国家 烟草|专卖局$评为|全国 烟草 行业$卷烟|打假 标兵
外婆|用|长长的 指甲$刮着 舅舅|窄窄的|脊梁沟
于是$颇懂 斯文的|外公$顺口|给我 起名|叫 淼儿
分别 确定|排位赛$三站|分站赛$参赛|棋手 资格
瓦努 阿图|共和国 总理$瓦努|阿库党 主席|纳塔佩
骗取|出口 退税款|十万元$因 案发|未予|办理 退税
巡警 承诺$杜绝|乱 截车$乱 罚款$乱 扣证的 行为
英国|赫德斯 菲尔德$一家 毛纺厂$用|熟练 工人|剪 羊毛
芬兰的 姑娘们$总是在|除夕 夜晚$把 鞋子|向上$抛 出去
也 不会|刮掉|皮肤 表层的 油$这对|皮肤 干燥的 人|很 重要
那就可|作为$撞死|肖伯纳的 好汉$而|永远|名垂 史册啦
看来|离此 不远的 某处$一定有|一窝 狼崽$在|嗷嗷 待哺呢
希望|能够 让人们|随时 随地$想要有 凉风 吹来$就能 如愿
用 胸中|灼热的 鲜血$创造出|永不 凋谢的 诗歌|和 花朵
狄公|从|桌上 拿起|宋秀才 那册|玉笛谱$轻轻 纳入 衣袖
约翰|不使 子女|处于 浑浑 噩噩$只知 享乐的 状态
日本人|不担心$小偷$大贼$跳越 柜台|抢钱|抢邮票
我从那|无边 无际|莽莽 苍苍的|重山 峻岭 中|收回 视线
弓子 那双 眸子$好像 因|悲哀|而|湿润后$又因|愤怒 而|炯炯 有神
冷水 江路段|成为$株六 复线|湖南段$贯通|最早的 路段
组建|四支|精干的|抓捕 小组$派往 外地$执行|抓捕 任务
从|整田|育苗|插秧|除草$施肥|喷药 等|每个 环节|予以 指导
杨增武 撰写的$贫困 地区$跨世纪 财源|建设 研究 一书
玛雅 狂欢节$挖掘 远古 神秘的|玛雅 文化 习俗$艺术 宗教|和|表演 元素
新邱 露天矿|下岗 职工$共产 党员|张少华$自办 养鸡场|脱贫后
亚当斯 在|探究$猫 喜欢吃|猫 薄荷的 原因时
马 踏|飞燕的 称呼$既 形象|又 优雅
而且|黎广修$还把|筇竹寺的 方丈$梦佛 长老
赶紧 用|遥控板$把 音量|调到$还有点|刺耳
采用|预约 作业|应急 通关$加班 加点|等 措施
贵州省|亏损 大户$遵义 铁合金厂$一举 扭亏
他们 昨天|从|望远镜 里$看见过|一头 母熊$带着 两头 小熊
斯坦尼茨|以|十胜|五负|五和的 成绩$战胜了|楚凯尔 托尔特
别古恩 教授$打算 抓着|路易 拴在$洞口 石头上的|绳索 下去
所以|我们 宁可 乖乖地$在|腋窝的 腺体上|喷洒 除臭剂
这本|新杂志 创刊号$就 销了|五万 三千 九百|九十一本
你是 一个|载满 咏叹$载满 赞誉$令人 怜爱$令人 迷恋的|古老 精灵
早上|我 热心地|帮|左邻的 阿姨$把 小妹妹|送去|托儿所
恰恰|在|山下|玉米 苗儿|口渴的 时候$被|温暖的 春日|所 融化
至于|买|玛莉凯 化妆品$请找我 之类的|广告 贴纸$更|比比 皆是
连续 做了|四万|五千|零二十七次$柔软 体操|跳跃 等等
女 运动员$在 晚年 发生|乳癌$和|生殖 系统癌的 机会$都 较 小
这篇|童年 往事$写成了 一个 短篇$叫做|匪兵甲$和 匪兵乙
老钢琴 青春|崔保国$中国 师大 钢琴 教授|刘老$与我|多年 为邻
爱情|终于 破裂$倘若|布鲁斯|从 开始$就|坦率地 与玛莎|交换 意见
亲吻 嘴唇 前$必须 用酚|处理 过的|玫瑰 香水$擦洗 嘴唇
那个|污秽 而|皱缩的 小猴爪$已被|随意地 放在|餐具柜 上
他把 自己|说成 是个|为|免遭 辞退$而|过分 卖力|工作的 人
也许|身后 正|追随着 一双$娇嗔中|蕴含着 一丝|委屈的 眼睛
王德昌|率领|工兵营 兵士$连同 爆破手|约|一百人 左右
世界|卫生 组织$爱滋病|特别 计划 主任$乔纳森 曼恩 医生说
白桦树 却|仿佛 在向 白云$春天里 呈|积云状的 白云|伸展
爸爸 妈妈|就该 给我 买|学生服$和 帽沿 闪光的|学生帽了
一位 矮胖|而|风情 万种的|半老 徐娘$接过 公文纸|钻研 良久
彭梅魁|趁|国庆 休假$去|看望 伯伯$刚被 罢了官的|彭德怀
甚至|把|穿在 身上的 衣服$拿到|当铺 作押|换点 伙食费
第二天|照样|精力充沛$精神抖擞$意气风发$斗志昂扬
已经|与|出租人 签订了|住房|租赁 合同的$多个 廉租户
轻度 中毒$会 造成|嗜睡$头疼$头晕$恶心$呕吐$胸部 紧束感
漫山 遍野的|沟沟 峁峁$枝枝 叶叶$花花 草草$虫虫 鸟鸟$都在 喊叫 我了
对|领导 要求|做到|三减 三到$减少 会议$减少 文件$减少 应酬
当地 军民|又 只能靠|漂|牛皮 筏子$走|藤条 笼子|溜索 渡江
转为|盆景 鲜切花$盆花|观赏 苗木 种苗 等|多种 产品|并重
存款 总额|从|月底 约合|一亿 埃镑$增值到 相当于|两亿 埃镑
就剩|俺老师 一个$俺爹 让俺|跟 俺爷$看|承包的 菜园子
德国|著名 展览城|汉诺威$拥有 近|三万 平方米的|展览 面积
国家|允许 设立|中外 合资 经营|印刷 企业$中外 合作 经营|印刷 企业
有人|把宝 押在|阿根廷|经济 崩溃$货币 贬值$停止 偿债 上
房屋 拆迁|管理 部门$在 发放|房屋 拆迁|许可证的 同时
凝聚了|不少 可以|升华为$乒乓 精神$乒乓 文化的|精神 财富
如|打打 牌$搓搓 麻将$跳跳 舞$玩玩 保龄球$泡泡 网吧 等
湖北省|枣阳市|棉麻 分公司$非法 经销|掺杂 使假 皮棉案
因此|又得 有个 帮手$在旁 为|自杀者|砍下 脑袋
勾魂鬼$恐怕 真懒得去|相一下面$倒也 未可知
你|是否 依赖于|饮酒|或吃 安眠药$来|帮助 入睡
顶住了|寡妇们$对她 这个|准 寡妇$蔑视的 目光
咳嗽|儿童 咳嗽 很频|且 很猛烈$则应|尽快 送医院
似乎 比|计算 他|总共 植了|多少 树$还要 困难
靴子|和 袜子$经他 用|刀子|割开 后$才能 脱下
哒哒 哒哒的|扎字声$整整 响了|四十个 冬夜
罗大人 便|赶忙|打发 在下$来这 寺庙街|打听 虚实
独自 跑到|群岛 总督$博阿奈 家中$呆了 下来
怪圈 与|太极图$西方|有 科学家|曾|研究 指出
说|杨秀青|陪 姨太太$曾在|公园|打 网球|骑摩托 云云
一边|反复 唱着$噢 嚎|噢 嚎 耶呀$一句|简单的 唱词
鲁中南 山区|围绕$桑蚕$茶叶$药材$干果 生产
据|新华社 白沙瓦|三月 一日电$记者 孙浩$喀布尔 消息
推进|反腐败 斗争$访|中央 纪委|常务 副书记$曹庆泽
郭海龙|郭海博 弟兄俩$多年|痴心于|浮雕 艺术
并|宣布|卡塔尔$将向|该 基金会|捐赠|十万 美元
确定|外形 尺寸$与 家中|安放 尺寸|是否 合适
长江$嫩江$松花江 流域$发生|特大|洪涝 灾害
翁牛 特旗的$布日|敦|嘎查|嘎查$蒙古语|意为 村子
潘海兵$潘志龙$潘斌武|等 三名|犯罪 嫌疑人|先后 归案
我|则 对着|眼前|所 陈列的 糖果$狂喜地 凝视
他把 他们|装扮成|一副$孤独|凄苦$和 绝望|无助的 样子
水手|闲散 在|甲板 上$聆听着 收音机|播送的$娓娓 动听的 音乐
严禁|下层 社会$把 手绢|作为 礼物$相互 赠送
由在|同一块 土地上$经营 农场的$伯父|伯母|收养
将|训练 有素的|精锐 部队$撤出|土耳其 战争
伟大的 剧作家$不得 不把|修改 过的 稿子$给他 塞在|锁孔 里
他从|扔在 岸上的|破 船板中$找来 钉子|做 鱼钩
但|不少|老实的 农民$一来 对|新政权|摸不清 底子
浦正|考虑$要 编一些|宣传|婚姻 自主的 材料
襄垣 剧团 等$又把 小说|改编成|秧歌剧$搬上 舞台
一个 好|讥诮 别人的 评论家$就用 此题名|挖苦|那群 画家
本来|日本 民族$离开|原始的 区域$并不 甚远
同时$也 可以|训练 人$养成 一种$简洁 回答 问题的|条件 反射
美国|一系列|商品 电影$把 大猩猩|描绘成|粗野
这样|就可以 检查$并 发现|哪些 地方$最|引人 注目了
琼斯 姐妹|走路 时$她们 甚至|还能 跑$不紧 不慢
又|吩咐|总务 人员$买了 八吨|烟煤末|堆在 库门口
孔祥熙 知道$不能|公然 侵夺|吴鼎昌的 利益
狗熊 露出|钉耙 似的 牙齿$一次次地|啃|他的 脸
住在|新 哈勃郡的|群山间的 一处$僻静 农庄 里
宋太祖|派 间谍$去 南唐|买通|林仁肇的 随从
那 小子|惊诧|而|恐惧的 神态$使 魏贤|感到 惊奇
土尔扈特汗|阿玉奇$遣使 萨穆坦|假道|西伯利亚
曾|充任 总管|皇家 事务的$总管 内务府|大臣
山东 巡抚|国泰$及|布政使|于易简|贪污 巨款
嘉庆 四年|正月 初三$一七 九九年|二月 七日
可|结果|弄 清楚了$却是个|立体 几何|方面的 问题
第三局|按|菲特夏的 建议$改在|小屋里 举行
他把 一根 稻草$用 唾沫|沾湿$横向|搁在 甲骨上
消息|立即在|教堂 外边$男人 中间|散布了 开来
明代 燕王|朱棣$以 讨伐|黄子澄 等为名$起兵|攻破 南京
如|匈奴 首领|单于的 子孙$就有 不少|姓 单于
聚会|欢庆的 人们|畅怀 痛饮$用|蜂蜜|酿制的 佳酿
付给|从|巴黎 请来的|刽子手$报酬|五十四 苏
海顿|接受 匈牙利$埃斯特哈惹 亲王的|聘请
生怕 呕出的|血沫$会 弄脏 别人|借给 你|穿的 毛背心
我去|为一个 学院$关于|安提戈涅的 论文|写 评论
吸取 教训$就像|以前|从|没有 人|得过 这种|教训 似的
四处传来 噼噼啪啪$硬币 敲击|金属的 声音
赛车$以及|应用|最 先进 技术的|电子机 等等
我 没能 见过$谁能 把|纪念品 扩大到|如此 范围
有|呼吸$有|欢歌$有|悲调$有|悄悄 独语$有|暗暗 哭泣
忽然 看见$林子里|有个|平安 客栈的$油纸|灯笼 招牌
剩下|阿尔基 马德$毫无 遮蔽 地|呆望着 太空
这个|跳伞 者$便会 保持|当时 速度$以|恒速 降落
骑着 马$最好|还是|骑着 骆驼$走过|荒凉的 戈壁
武侠|与 伤痕$哪个|更富有 崇高$与 英雄主义
硬是|将 官司$由|地方 法院$一直 打到|最高 法院
戴眼镜的 葛兹$在|摇摇晃晃的 车中|站 起来
落叶|刘良初 中国$猜不透 你的 心思|你的 内涵
营养 不良$也会|导致|指甲 变脆$而|容易 折断
各方面 条件$与你 相差|不多 的人$得到 提升|或|重用
你 能否|果断地$向|要求|公平的 心理|挑战呢
商行 出售|春耕 种籽的|分类 价目表$潮涌 而至
海鸥 之死|约翰 罗兰|英国 袁庆春$在|北大西洋 海岸
但|我 也认为$一个 父亲|应该能 解答|一切 问题
探险家|雅克 朗兹曼$和 他的 探险队$到达|塔克 拉玛干
还有 什么|比 猫足$更能 表现出|那 轻|而且 软
被|动物 咬过 等$破损|而 无法|修的 钞票$送到 华盛顿
夜|又以 它$旧衣 般|熟稔 温和的 气息$拥着 我
然后|扯开 裤头|哗啦啦$立在|当街|咪咪地 撒尿
让 他们 看看|小 虾片$变 魔术 般的|扭动|膨胀
也需 等候|该市长$将|一柄|市民 宝剑|授予 她后
书生 学子们$常常 追问$假如 地球上|没有 月光
两人 都是|日本 美术 专科学校$毕业的 学生
欧拉卜村的 村长|阿里 库$也曾 参加过|搜索队
女王 敲门|阿尔 倍托$和 维多利亚 女王|夫妻 感情|和谐
故又 疑心|自己|轰轰烈烈 几年$是否 真正 爱过|和 被爱过
怎样|从|绮梦 年华$走入 柴米油盐|粗糙的 生活里
她的 联想$是像|拼图 玩具|碎块 那样$产生 出来的
在|妻子 企图 跳|尼亚加拉 瀑布$自杀前 很久
迪克|经常 接到|奥德莱 安妮|疯疯 癫癫的 电话
楼梯 脚下|挂着 一块|招牌$白医师 诊所|在楼上
诸如|故意 笑得|爽朗 豪放$可 称之为|政治家型
阿伯拉罕 林肯$遇到过的 敌人$你 我|都曾 遇到
感人的 是$点点 归鸦|急急 匆匆地$朝|窠 里|飞 去
也许$我 有点 喜欢$看到 你那|昂着头的 样子
另外 两辆 车上的|军官们$早已 下来|等着 他们
揉面时|喜欢 用|擀面杖$有节奏地 敲打|案板
虽然|也 收集了|当时 流行的$各种|塑料 小钢笔
雷蒙德 卡丁|在 许多人 眼里$是个 可爱的|乡下人
你的|卫星 电视$共用 接收$播放 设备|发明 专利$我厂 买下了
给 小叔的 信$一天 一天$一封 一封地|暧昧 含糊
阿岭|要带 阿香$这 糟糠 之妻$去 台湾|安享 晚年
却 发现|早点 铺里$根本 没有|安装|篮球 筐架
梅馥|就要|跑遍$整个 上海的|新华 书店|觅书
缪斯|没有 沉默$唐若水|一九四二年|八月 九日
而|演奏|第七交响乐$至少 需要|八十名 演奏员
仍然 缺乏在|管理 方面$能 运筹帷幄的|大 企业家
海明威|始终|态度 鲜明地$反对|法西斯 分子
在|短裤 口袋$或者|缝纫机 抽斗里$准 会有|某种 奖品
达尔文 乘|贝格尔 号$壮游 天下|回到 英伦后
牧师|用|动人 心弦的 话语$来 规劝|这个 罪人
国民 革命|军中 顾问$嘉伦 将军|亦|随之 到郑
孙眉|转托 几个|老年 同乡$向|茂宜岛 当局|证明
克拉科夫 旧广场$圣玛利 教堂 顶的|喇叭 报时
富兰克林 罗斯福$没能|亲眼 看到|这套 邮票
僧格林沁 俘去的|谈判 人员$也 关押在|圆明园 内
皖 三省|部分 师范学校$焚烧 小学|文言文 教科书
打开 冰箱$会 影响 到|角膜 贮藏$需要的 温湿度
唐 皇家 此日|则要 举行$规模 盛大的|大傩 仪式
各类|冠亚军 获得者的|动作$都 给|高速 录影
三条 隧道$几乎|全部 穿过$白垩岩的|石灰 泥层
周恩来 还是$朱德|和 孙炳文的|入党 介绍人
只有|耳朵 听见|脚掌|咔嚓 咔嚓地$抠进|雪地里 去的 声音
主导轴|稍有 弯曲$就将 产生|难以 消除的|颤音
咱得|能在|老婆 孩子 面前$把|胸脯 拍得|嘭嘭 响
当|死者的|至爱 亲朋$团坐 一堂|举行|丧宴 时
婚姻 介绍所里|红娘们$对|此类 姑娘|爱莫能助
好胳膊 好腿的$你 小子|干吗$非要|留在 北京
葡萄汁|或 柠檬汁|等 化妆水|涂擦$并 按摩 皮肤
开会 等 事情$把 我|白天|晚上的 时间$完全 占满了
比姆 拉岱维$被她 公公|厉害的 咳嗽|惊醒了
使|两个 骑师$恰好 坐在|两头|飞奔的 驴背上
春 晨|淡淡的 阳光$又在|呵哄 蓓蕾|茁壮 绽放了
妹妹|贺怡的|突然 到来$使|贺子珍|欣喜 若狂
断舌$证明 了|于|将|舌头 伸入|陈的 嘴里$这一|客观|存在的 事实
臭鼬|骚扰|特洛伊 居民$大约 有|十年 历史了
三月 间$发现|大肠 内|接近|肝部 位$有 一 肿瘤
你真 走运$威尔逊 开|摩托车$撞倒了|一个 行人
去|购买|比|擦过 屁股的|废纸$还 无用的|伪钞 票
但却|驱使他$考虑|享受 某些|似乎|无害的 奢侈
他要求|每位 观赏者$将其|最为 欣赏的 妙笔$都|标上 记号
但|文宗|却 偏|独 赏识$柳公权的|熏风 自 南来
最|沉酣的 痛感$逼成了|最 锐利$最 沉酣的 快感
象|碾压 香烟头 一样$把它 碾折在|烟灰缸 里
索罗|用|驼毛 刷$掸去|未 附着于|玻璃上的 银粉
他|踌躇 许久 后$认准 一种|又 便宜|又 洁白的|大 糖丸
老信客|又|告诉 他$沿途 可住|哪 几家|小 旅馆
交通 艇长$因怕 强行 靠岸|造成|艇|毁|人亡的 惨剧
姑娘|像|蝌蚪|丢弃 尾巴 一样$丢弃了|过去的 自己
收 破烂的|酒干|倘 卖无$和|歹铜|旧锡|倘 卖无
我们 就这么|狼吞 虎咽地$对付着|又粗|又硬的 糙米饭
撇下他$孤零零地$承担 起|抚养|孩子的 责任
绸缎|甚至|洋娃娃$都 搬到|欢喜宫的 平台上
胱氨酸$已 临床 应用于$医治|肝炎|及 各种|脱发 症
巧取 无核法$岳阳 晚报|陈浪|清朝|康熙 年间
穿上|新买的 猪皮鞋$闯|华东 考区|金陵 考场
巩俐|尽管 演过|红高粱 里的$我 奶奶|等农村 角色
三军 统帅|毛泽东 主席$亲自 向|诸位 将领 授衔
当 我们|如月的 面庞$因 衰老|和 疾病|扭曲 变形
由于|牛顿 建立的$经典|物理学 大厦$土崩 瓦解
父亲|带 我去|著名 玩具商$唐纳德 斯帕克特家$擦洗 玻璃窗
然后|一匣 两匣$用 染成 粉红色的 麻线$捆扎 起来
浑身 上下|只 穿着 一条|短短的 裤衩$挥锹 挖渠
文人 笔下的 鬼|陈双法$台湾 造形|迥异|鬼|多变
要|出够 价钱$来 收买|店 老板$为 你|看住 电话
据此|纂写 出|海尔 产品|调查 问卷$统计|分析 报告
桔山|新区 工委$为|妥善 安置|失地 农民|就业
经过|党委|集体 讨论 决定的|仓库$周末 育才 学校|应运 而生
婀娜 多姿的|顶碗舞$赢得|阵阵 掌声|和|喝彩声
双方 已就|欧盟|利用|北约|资源 问题$达成|原则 协议
巴以 争端的 核心$仍是|巴勒斯坦|建国 问题
采取|降职 任用|离岗 培训$改任|非领导 职务$转岗|待岗 等 办法
天津|普利司通队$客场 击败|云南 红河队后
提出$二零零八年|北京 奥运会的|绿色 奥运$具有|更 广泛的 内涵
托拜 厄斯教授$在|仔细 端详|人类 头盖骨 模型
因|镇川 之宝|都江堰|巧夺天工$润泽|不绝|而|水旱 从人
肥东县|清退|中小学 乱收费 金额$达|十多 万元
大大 削弱其$争端|解决 机制的|权威性|有效性
浙江 磐安$发现|罕见|串珠状$高山|断层 湖群
为|香港 代表团$取得了 九运会的|首枚 金牌
重点 发展了|苜蓿$红枣$苦碱水 养殖$等|几大 产业
九运 圣火$在|广东|奥林匹克 体育场|熊熊 燃起
想|群众 之 所想$急|群众 之 所急$办 群众 之 所需
这 对$阿富汗 民族|造成的 灾难$是|无法 弥补的
法国|索邦|高等 研究院$首位|荣誉|人文科学 博士
积极 关注$历史|变革 时期|现实的|热点 问题
陕西的 舞蹈|陕北 大秧歌$热烈|活泼|奔放|诙谐
通过 加快|土地|资源 保护$来 夯实|农业 基础
记者 踏进|绿树 鲜花 环绕的$康美镇 铜钵村
征文|截止 日期为|二零零四年 六月 一日$以 当地 邮戳 为准
右玉县 地处|晋蒙 交界$黄土 丘陵|缓坡 风沙区
境内|水土 流失|环境 污染$和|生态 破坏 严重
垃圾 污染|修建 电站$教师|工资 拖欠$代表|边听 边问
北京市 出台$促进|私营|个体经济|发展 条例
随后$诸如|动物 疫病 控制$药物 残留 监控 等
公章|和 检验 报告 书$及|包装材料 等|也 均系 假冒
要到|海拔|四千 多米 高的$浦虎 龙洞山|察看 阴河
防止|航空器|与 航空器$航空器 与|地面 障碍物 相撞
听听 那|撒泼 打浑$自虐 虐人的|说唱 段子|和 相声
其中|海外 潮汕人$及 台港澳 同胞|投资$占|总投资额的|百分之五十 以上
图为|首列 客车$通过|陇西|至|云田 乡段 铁路
我们|高度 评价$俄方|维护 反导 条约的|坚定 立场
霸州市 杨芬港乡|党委 书记|牛双秋$到|阚里墅村|住村|访户
上面 标着$高优|豫麦|陕优|等品种 编号
西安 卫星|测控 中心的|测控 任务$日趋 繁重
何必|非|挤进|大宅门 里$别别扭扭地 跑龙套呢
钢板墙|顺坡 而下$伸向了|波涛 汹涌的|太平洋
压 死|埋 死|炸 死|饿 死$累 死|冻 死|病 死的 矿工
她|原本 答应$给|身患|白血病的 弟弟$捐献 骨髓
日本|磐田|朱比洛队$以|三 比 一$胜|韩国|水原 三星队
因|土炼油|爆炸|着火$造成|人员 伤亡|近 百人
解剖|法轮功$欺骗|愚弄|残害 群众的|典型 案例
曲线型 家具 给人 以|活泼|轻松|优雅 柔和|丰满|活动感
也 对 那些$虚假$矫情$卖嗲 卖乖的|语言 制品
他们|也 不知道$乌方 什么 时候$会 掐 断气管
杭州|横山桥 居民区$有位|叫|陈亚强的 残疾人
男性 左撇子$是|女性 左撇子的 两倍
屋舍 四周的|树木$已被|砍伐 干净
诗人 艾青$多次 陪外宾|去 访问他
他把|那 一大碗|青菜|豆腐|蛋花汤$先 喝完
顺手|从|讲台 边的|喷泉 中$取|杯 水 饮
撩人的 流行舞|很快$风靡了 首都
上面 用|印刷 字体$写着 给|凯兰达
我是 尝$冬天|晒太阳 滋味|尝得|舒服 透了
学校|隐蔽 在$七弯|八拐的|弄堂 棚户区
又|哪里 能知道$寒窗|只影的 孤独
拈拈|下巴上$几根 稀疏的|胡子 说
男 与 女|额 碰 额$叽哩 咕噜的 细语
他 像|小男孩 般$快活地|冲我 招呼
传闻|通过|匿名 电话$传到了 警长
杜洛夫|乘船|从 敖得萨$去 雅尔图
这条狗|总是$龇牙 咧嘴地|威胁 我
同卵|双胞胎$来自|同一个 受精卵
竟|鬼使 神差地|奔跑着$追赶 上他
苏联 袁永乐$撑竿 跳高|渊源 悠久
谁 听说过|换鞋$就能 修好|电钻的
聪明的|狄 浦斯$很快地|猜了 出来
紫罗兰|用 充满|哀求的 声调$回答 她
我|边 说$边|双手 捧过|黄毛 茸茸的 小东西
更得|严防 丑恶$偷偷 潜入|你 心底
玩 扑克|竟被 姐姐的|氢弹$给|炸 哭了
风暴|掀起了|滚滚 巨浪$漫上|堤岸
今晚|莫斯科 大剧院$上演|蝴蝶 夫人
珍刀|披散着 头发$穿着|旗袍 来啦
春天|都 喜欢|往 窝里|叨 些$毛毛 草草的
树上 旅馆$在 东非洲|肯雅的 西南
台儿庄|苍灰色的 轮廓$隐隐 在望
施 老伯|拿起|扫把 畚箕$就|往回走
才 明白|为什么 贾琏$平时|省吃 俭用
混混们|哇哇 大叫着$抱头 逃窜
如|普留图$扮演|专干 蠢事的 角色
请你|告诉 健生$也 明白|这个 道理
只好 靠|眨动 左眼$与|门迪宝 沟通
老红军$眼睛|闪烁 出|幸福的 泪花
波黑 塞族|枪手$包围了|萨拉热窝
床单|被 漂白剂$洗得|使|皮肤 过敏
但他|仍然 拖着$病病 歪歪的 身子
痛痛 快快|随心 所欲地$折腾 一天
果真|如$繁星 般 密布的|明崖 暗礁
最后|一齐向 白犬|发出$恶声 吠吼
沃森|含恨$离开了|绿色 和平 组织
争先 恐后地|跑出 家门$滚起了 雪球
则|往往|在 台下|混乱 之中$眼送|秋波
车子|在|凹凹 凸凸的 路上$向前 蹦着
肉 上面的|细菌$和|寄生 虫卵|很多
后来|慢慢 想 知道$金钱|往 哪里 去了
摘了 几枝$黄陵 旁的|扁柏叶 给她
缺少 运动|跟 沮丧$有着 密切 关系
客人|可以 挑选|棉质$或 麻质 寝具
想|抹掉那$遮掩 清光的|灰色 皱纹
吕西 安里歇$才算|打开了 闷葫芦
看这|曹二公$可 不就是 每日|朗朗 爽笑
火药味|直冲 鼻子$刺痛 囟顶门
明天|你 该去|逛逛 这些$久违的 地方
总统|阿基诺 夫人$召开|内阁 会议
哈利 波特$年年 名列|畅销书 榜首
偶然 可见|一两块|碎陶片$板瓦 筒瓦
肮脏|散发着 异味的 衣物$被|熨烫 平整
频频 遭受|无聊 挑逗$粗言 谩骂$谎报 警情
还|纵容 支持|配偶 子女$公开 捞钱
王佑堂的 亲属$想|偷偷|转移 财产
爱岗 敬业$埋头 苦干的|奉献 精神
趵突泉$平地 涌出|三尺涛的 胜景
广东省|体育局 局长$董良田 认为
纵火案$勒索案$贩毒案$分别 减少了
调整$证券|股票 交易|印花税 税率
翁巾英 女士|重病 缠身$卧床 难起
本可|丰衣 足食$快快 乐乐$过 一辈子
彭亮 之母|李银秀$系|突发|脑溢血 死亡
某部|炮团|工兵营 官兵$手持|扫帚 铁锹
鲜花 簇拥$灯火 璀璨$欢声 笑语$笙歌 一堂
问卷 调查$走访 调查$和|座谈 调查
零阳镇 琵琶村|小组 村民$郭凡楚
愿意$永远做 中国的|好邻居|好朋友
上千 军民|肩扛|防洪 沙袋$穿梭于 堤前
一位|研究者$夸大|乃至|捏造 成果的 动机
十米高 棚顶的$大盏|无投影 照明灯
政府 希望$以此 恢复|投资者 信心
脱胎 换骨|奔 新生$自甘 堕落|入 苦海
我们|甩掉了 喧闹$和 闷热的 新德里
旌德县$组织|抗旱 救灾|互助组
罗雪娟$百米 蛙泳|夺金
一系列|相关 产业$都会|热闹 起来
别再 让|街头的 游医$坑害|男性病 患者啦
鹤壁 天马$通信 股份有限公司 党委
狠抓|畜禽|品种 改良$畜禽|结构 优化
熬 粥|家乡人 称作 糊涂$蒸 窝头|贴 大饼子
热情 豪爽|面子 义气$地位 勇敢|捧场 客气
其|贫困 人口$占|全球|贫困 人口的|百分之 三十
宽敞 明亮的|门诊 大厅$温暖 如春
孟连县|傣佤 拉祜族$发展|绿色 企业
脑|脊髓$脊髓 液|眼球|属 强传染性
让|犯罪分子|闻风丧胆$胆战心惊
捣毁|制运|存销|假冒 商标|卷烟 窝点 五十个
商品房$平均 销售 价格|稳中 趋升
防范|和化解 寿险 利差损$起到|推动 作用
脸上|笑靥 盈盈$与|扁担 弯弯|齐律
全口 义齿$即|全口 缺牙|修复的 假牙
蛇年 春节后|老老 实实$当了 几天 学生
不应 为了|热热 闹闹$而|哗众 取宠
烧土焦$办 砖厂|开 铁厂|搞 水泥厂
将 按照$对外 双边|多边|承诺|降低 关税
十六 罗汉$便 普遍|受到 我国|佛教徒的 尊敬
并 由|南京 警备 司令部$和 首都 警察厅|会衔 布告
她还 担任了|孟买|残疾 儿童|协会 主席 等职
美国|向 英国|购买了|位于$今|北达科他州的|一部分 土地
人们|越来越 注重|式样的 别致$和 装饰的 华美
哪一位|比|上任 前|轻了$或和 上任前|一样 重的
将其 尸体|加以|防腐 处理后$葬在|松岭 公墓的|威尔伯 墓地里
且不说|小二黑 结婚$是不是|单单 写了个$男女 恋爱 故事
小二黑 结婚$活在了 千千万万|农民的 心里
同住在|巴黎市外|七十五 公里的 席芬尼$一幢|盖得 不整齐
可以 看出|他|失足|跌落的 痕迹$他是 朝|东边 滑落的
当 他的|八月的 乡村$在|鲁迅|帮助下|出版后
燃料 烧完了$便 只能|听天由命$慢慢|滑行 而已
则|太空 旅行的 费用$可以 减低 至|每磅 一美元|或 更 少
如果 再加上$东欧|及 非洲等|私人 拥有的 黄金
他的|两个 孩子$从 帐篷里|蹦蹦跳跳 地|跑了 出来
详细 询问了|他们的 处境$及与|俄国的 关系
雄蜘蛛|为了|提前 通知 母蜘蛛$自己 要去|登门 拜访
后来|荷属 圭亚那$和|法属 圭亚那|发生 矛盾
每 发现|一只 跳蚤$她就 用 小炮|瞄准后 轰击
自有 一番|精打 细算$而又|纯粹 理智的 原因
就像|希腊 神话 里的|皮格 马利翁 国王$热恋 自己 雕塑的
流水的 嘈杂声$在 黑暗中|愈发 显得|震耳 欲聋
袁震|不愿意 拖累 这个$才华|出众的 年轻人
谁知|那个|会说 谎话的 威尼斯人$毫不迟疑地 回答道
种族 偏见的|强大 影响|所 形成的$强大|壁垒
布鲁诺|所以 面对|宗教|裁判所的 火刑$面不 改色
我|曾向 母亲 说过$学校|供应的 午餐|太 糟糕了
全世界|一切 文学 作品中$最|著名的 六个字
比如$战国 时代|田|齐襄王 法章的|后代$本 姓田
美国的|婚姻 习俗$兼收 并蓄了|异地 传统 惯例
西德的|电子 探矿 手杖$能|帮助|勘察 队员 找矿
至今|也 没能|琢磨 出$沙鸣 形成的|确切 原因
正当|我 母亲$朝着 她|停 汽车的|地方 走过去
除了|有一次$可怜巴巴地 掉出|五个 硬币外
于是|简就 煞费苦心地$越俎 代疱|替我 去办
人们 还可以|比较 正确地|估计 水温$以免 不测
体操|也会 因|尾巴|可以 保持 平衡$而使 动作|更难
感谢|美好的 传说$和 产生 传说的|美好|活泼的 心
听着|不断 上涨的|大水$哗哗地|冲刷着 房基
我 感觉|哈德斯岱 太太|双手 用劲$抓紧|我的 肩头
陈寿|就在|诸葛亮 传里$讲|诸葛 父子的 坏话
实际上|在|这片 街坊$没人 认识 这个|送奶人
把|小说 改成|电影 脚本$到底算 改编|还是算 编剧
欧永祥 父亲|头一次 送我 鲜花$是我|九岁 那年
由|伦敦的|洛德 保险 公司$赔给了 胡伯曼|这笔钱
高士其的 灵堂前$摆放着 金爱娣|自己|题写的 挽联
不管|这块|东方的 土地上$有|多少 种|不同的 语言
心脏病 突发|和|其他 毛病$如|腕管 征候簇 等
河北省 团校$因此 也就|完成|反右 斗争的|指标 任务
当我|在|华盛顿$收拾|离任前的 行装时
一位|酋长国 首脑$送给她 价值|三百万 美元的 珠宝
像|往常 一样|嘟囔了 一句|粗暴的 话$就 走了
一阵阵的 焦味$就自 厨房的|锅子 里|飘了 出来
但你|如何 才能$快乐的 去|迎接 每个 日子呢
犹如 一根|通红$秀美$新鲜$结实$饱汁液的 胡萝卜
我到|教学楼 后$老太太的 酸奶档|喝 两瓶|酸牛奶
并|请求|丘吉尔 夫人|说服丈夫$上那儿 观看|祝寿 节目
红磨坊$使 蒙马特|从此 成为|巴黎|寻花 问柳的 乐园
齐德勒 就把|爱丽舍 蒙巴特 舞厅的|表演剧团$挖了 过来
你|是否|靠 饮酒|或 镇静药$来 稳定|急躁 情绪
这首诗|后来 更由|格林卡 谱曲$而 成了|千古 绝唱
并|感受 到|大风 掀起的 海浪$正 冲击着|遥远的 岛屿
当他|把 项链|递给 拉姆齐$正 准备|开口 说话时
新婚 才|几个月的 沈守和$回到|阔别 四年的 祖国
我 脑子里|充满了|复活节的$神秘 传说|白兔
上面|详详 细细地|列举了|本州内$都有|哪些 医院
逼迫 上山|皈依 佛门$而 又被|说成是 假尼姑的 黄兰
不良 片商|又|挟 尼姑 打扮的 黄兰$到|戏院 露面
红旗 轿车|车速盘上|标明$最高 时速|是|二百 公里
让|头脑 可获得|短暂 时刻$以|记牢|或|推敲 有关 信息
但|没有像|岛村 先生的 忍字$那么 贴切的了
州长|迈克尔 杜卡基斯$不久前|刚刚|否决了 死刑
譬如|当 我们 涉想$某某 漂亮的|小姐的 时候
凡|航行 阿拉伯海|和 印度洋的|远洋 货轮$要|注意 寻找|德堡轮
一架|灰色 海上|侦察机 呼啸着$离开|亚丁 机场
民族 性格|多多 少少$受到|天然 环境的 影响
到|北极圈内的 阿拉斯加 冰湖上$替人|破冰 捕鱼
她|常常 肝 疼得|整宿 整宿$翻来 覆去地|睡不 了觉
情到 深处的 寂寞$是|幽谷里 一条|清澈 见底的 小溪
了解|配偶的 喜好|与 厌憎$能 推动|婚姻的 和谐
以致|男爵的 母亲$看到|朋友家的 树下|落满 枯叶时
加拿大|短跑家 约翰逊$以|九秒 八十三的|近乎|神奇的 成绩
人们|在|这些 活动中$怀念 某些|值得 怀念的 时刻
脑子 就|习惯于$根据 来自|视觉的 信息|判断 上下
泰戈尔的 诗$情感 浓得|能从 笔尖上|掉下来
有的 恐怕$也是您 头皮上 哪根 神经$弹出的 曲子
尽情|赞美 那夜空下$杂乱 丛生的|棕榈 树林
第三号 汉奸头目|周佛海的 私寓$突然|浓烟 滚滚
一八八零年|一月 六日$纽约 时报的|社论说
他的 手指|由于|徒劳地|企图 扯裂 船壳$而|抓扒得|皮开 肉绽
现在|我要跟|快用 完了的|电池$和 越来 越少的|空气 供给|赛跑
在|西山原 招仙塔|旧址$重新 建起|十三层 佛牙塔
日本人|拎来 一条 狼腿$一桶 马奶酒|犒劳 长发叔
就是|踩着 裙子 下摆|摔跟头$也 非得|赶|那个 时髦
生活的 重担$压得他 脸上的 皮肉|龟裂 起皱
妻子|欲对 丈夫$保持|历久 不衰的|朦胧 美感
可是|人谋|拗不过 天数$偏偏|弗洛斯特|亲自 出面了
整天 看他|手执 钢尺|煞有 介事$在|房间|来回 测量
婚后 才发觉$心目中的|白马 王子|原来 是个 笨牛
天皇 巨星|杰克逊$被|报章 披露 说是|漂白了 皮肤
具体的 偶像$替代|抽象的 信仰|与 理想 等等
房屋|大都|星星 点点地$随意|散缀 在 树林中
我们 会向|孩子的|祖父$祖母 骄傲地|大声 宣布
结果 其|平均 血压 为|二百 六十$一百 六十|毫米 汞柱
第二天|威廉森镇的 报纸$在 头版 头条|以|通栏 标题|刊出 消息
饿了|和点 面糊糊$在|煤油炉上 摊个|饼子 果腹
连|这点|残缺 不全的|父子情$也 显得|分外 珍贵了
姐姐 出落得|象 一朵花 般的$在 亲戚间|被 发现了
把|自己的 长脖子$向 这只|公驼鸟的 脖子 凑去
它们 用|尖利的 牙齿$嗑破了 好几只 驼鸟蛋
蒙田|把|这种 情形|称作 文殛$即被 文字 之斧|劈伤
小骨朵 似的 蓓蕾$就|密密 麻麻地|爬满了 枝头
满头 银发的 店主 雷$正在 调整|壁炉钟内的 乐钟
这也许|是|写 这则 题词的 朋友$始料 不及的吧
恰好|桂林师范的 校长|唐现之$来信 聘请|丰子恺|去 该校 任教
他|早已 忘了|每次 跨过|苏州河桥时$所产生的 厌 恶
比起 有些 留学生$从|露天 商场|免费 采购的 彩电
头发 直立的|铁路 信号员|提着 信号灯$摇疼了 胳膊
参加|罗伯特 西格尔|拍卖 艺廊的$例行 拍卖会
她将|话剧|捕鼠器的 版权$作为 礼物|送给 外甥
陈炯明 疑心|这是|革命党$对他 扣留|廖仲恺 行为的 报复
丈夫|还|仔细 询问$对|黄柏 除了 浇水|该 怎么样 护理
上面 所说的|两种人的 注意 目标$恰好 相反
某些 外交官$有时|把|外交 语言|同 谎言|等同 起来
我 发现|有一位|身穿|蓝色 毛外套的 女孩$很|注意 我
使得|蒋介石 对|宋庆龄$由 愤怒|发展到|憎恨
邓肯 为|缩小 自己|与 叶赛宁 之间的$年龄 差距
他俩|紧紧 搂在 一起$火车 前灯的 光|照在|他们的 脸上
村民们|先是 听到$从远处|传来 一阵 嗡嗡声
她 伴着|生性|乖僻 而|沉默|寡言的 丈夫$生活了 几年
勿 争辩|不重要的 细节$而 打断|别人的 话语
南方型$包括|中国的 内蒙$和|东南亚 各民族
一列|满载的 火车$从他的 头顶|呼啸着|飞驰 而过
但我 却|十分 佩服$他那种|认真的|自责 精神
伙伴们|沿着 那条|曲里 拐弯的 小道$爬上了 崖顶
随我 到|黑人|和|白人 合校的|操场上|去 看一看吧
赫鲁晓夫 夫人|满眼 含泪地$将手 放在|亡夫的 前额上
他们 听说$新台门 王宅的 私塾$有个叫|矮癞胡的 先生
学生 时代|怎么 被 处罚啦$继母|多么 恶劣啦 等等
现在|珍妮弗|以 百倍的 关心 照顾$回报|爷爷的 恩情
虽说|巴旦杏树$是一种|随处 都能|扦插 成活的 树
是$克劳地奥 阿劳|自己 演奏的|肖邦 圆舞曲
议会 请|瑞典 国王|奥斯卡 二世$派一位 王子|来 挪威 登基
孙中山|本着|兴起 革命的 宗旨$再次 抵达|夏威夷
与|孙眉|交往|颇密的 绅商$刘学询|找上 门来
堀江 谦一 先生$驾驶着 汽艇|成功地|纵绕了 地球
这个 少校$读了 约拿单$怎样 从|隘口 往上爬
诗词 风格|也由$高亢 激昂|一变为$低沉 消极
他|收集了$六千|六百万个 饮料|罐头盖上的 拉圈
他 就会把 妈妈$为|爸爸 留着 晚饭 吃的|烤牛肉 给吃掉
人们 以为|像上的 阴影$好似 脸上的|斑点 瑕疵
兰公爵 说起|不久 以前$敦煌|千佛洞|石窟中的 发现
传说中|江湖的 铁匠$打造|钉死 耶稣的 铁钉时
六十岁|时至 今日$他已|足足 矮了|四分之三 英寸
这|阴沉的 乌云$应该在|太阳|和 月亮 面前 隐没
陶宗仪 辍耕录$所记|元代 宰相|伯颜的 头衔
认为|太极|八卦图$是|卜卦 算命的|迷信 东西
但|其中|真正能|侥幸 逃脱 厄运的$却 寥寥 无几
被拿着|烧火棍的 父亲$追得|满屋子的 团团转
根据 其$六弟|黎锦明 短篇 小说$小画家 改编
身体 重心|与 横杆的 距离$比 跨跃式|缩短了
穿|紫色 服装的$主要 负责|油料 补充|及|燃油 装置
沉默的 朋友|勤奋 学习$苏联|赵秋长 莫忘记
几乎|每一条 航线$都为|角膜库 提供|免费 空运 服务
流放到|圣赫勒拿岛上$也 念念 不忘|玩 七巧板
冷嘲 热讽地 讥笑|切斯特菲尔德$这个|事后 恩主
春兰|在对|科研 创新 体系$进行|新一轮 整合的 基础上
电器 电子|自动车 等产业 研究所$和|海外 科研机构|为 扩散点的|高新技术|孵化 网络
西南 航空公司$将于|年底 开辟|成都 至 东京$和|成都 至 大阪的|国际 航线
目前 面临的|主要 问题$是|缺乏 相关的|法律 法规|和|合同的 认证
也有 一些 地方$根据|城市 保障 标准$及|镇村 财力 情况$对|本地 农村 劳动力$自办|养老 医疗 保险
已有|多名 巴勒斯坦人$和|多名 以色列人|死于|流血 冲突
他把|导弹 操作 号手的|训练 方法$引进 到|后勤|专业兵 训练之中
冯小刚$葛优$徐帆$也与|观众 朋友们|相约|不见 不散
用户 买来的|一升 瓶装水|喝完$就得|连桶|给厂商 退回去
我看|都应该 从|这个 角度$恐怕 也|只能 从|这个 角度|来理解
由|院党组 审判委员会|院长 办公会$院务会|逐项 审查
琢磨着|怎么 拉赞助$怎么 抢大腕$怎么 出彩儿
伙同 周某|绑架|杨某 女儿 未遂$又|另生 恶念
贵州省|兴义市|桔山新区 工委$在|新区 开发中$妥善 安置 新区|失地 农民 就业
扶持 发展|灯光 围网$鱿鱼 敷网$网板 单拖等|作业 方式
女单 决赛|是在|张宁$与|丹麦 老将|马尔廷 之间|展开的
印度 尼西亚的|西吉特|和 陈甲亮$战胜 丹麦的|拉尔森|和 劳格森
中国 国际 乒乓球|擂台赛$第十四场 比赛|移师|吉林 长春
率队 参加|此次 个人赛的$中国 自行车|代表团 团长|田俊荣 笑了
该|恶势力 团伙$犯有|聚众 斗殴罪$寻衅 滋事罪$敲诈 勒索罪$故意 伤害罪
确保|受灾 地区$需|救济 群众$每人 每天|至少 十斤|基本 口粮
记|二炮|优秀 共产党员$延庆 综合 仓库 主任|郑占云
进口 经营者$凭|进口|配额 管理 部门|发放的$配额 证明
感染者|均是|突然 出现|高烧$头痛$咽喉疼$虚弱|和|肌肉 疼痛
埃博拉 病毒的 传染$除了 通过|血液|和 人体|分泌液 传染外
上海|哈瓦那 农场$坐落在|哈瓦那|东南|约|公里的|马拿瓜市
激赏|男人 那种|横扫|裙钗 世界的 威风$我想 要谁|便是谁
截留|克扣|挪用|贪污|计划 生育 经费$或者|社会 抚养费的
还是 被迫|掏 五元钱$买了张|哈局|绥列|文化 车厢|区段票
没有 什么 消息$能比|皇太子妃|雅子 分娩$更让|日本人 欢喜了
光棍汉 与 外来妹$讲叙|西北 贫困 山村$几位|青年人|与 外来妹的|感情 纠葛$与|错位 婚姻
才能 革除|照抄|照搬$唯书|唯上$大呼隆|一刀切的 流弊
全团 要把|深入 学习 贯彻|七一 重要 讲话$作为 当前的|首要 任务|抓紧 抓好
我 曾因|偷画 一位|瘸腿人的 速写$而 招来|狠狠 两拐杖
邀请 苏昆$浙昆$上昆$湘昆$北昆$和 永昆|等 昆曲|演出 团体
温德博尔内 集团|董事长$罗伯特 温德博尔内|布朗 说
已 酿下了|洪水$干旱$沙尘暴$荒漠化|这些 苦酒
在|交款处$收银员|也 询问|是否 使用|欧元 付款
印刷 企业|接受 委托$印刷|包装|装潢 印刷品的
干部 推荐|责任 追究制$干部 考察|责任 追究制$和|用人 决策|责任 追究制
大佛 胸部|离地面 约|六七十米处$有 一块|长约|一点五米$宽约|一米的|天然 石壁
赤峰|严厉 打击$乱开$乱垦$乱砍$乱伐$乱挖$乱采等|破坏 生态环境的|不法 行为
二期 工程|主要 修建|三峡 大坝的$泄洪 坝段|左岸 厂房 坝段$永久 船闸
在|作品中|敦厚 朴实|和蔼 可亲$而又|威风 凛凛|巍然 屹立
采取|降职 任用$离岗 培训$改任|非领导 职务$转岗 待岗等 办法
大家|你一百|我 二百地|凑齐了 几千元$北斗的 日子|越过 越红火的 时候
漫山 遍野的|沟沟 峁峁$枝枝 叶叶$花花 草草$虫虫 鸟鸟$都在 喊叫 我了
档案中|不仅|记载着|走访 时间$走访 目的$走访 结果 客户 意见
存款 总额$从|月底|约合 亿埃镑$增值到|相当于 亿埃镑
刘斌|赴 云南 拍摄 一部$反映 我军|排雷 战士$排雷 生活的|音乐片
开设了|强国 论坛$体育 论坛$健康 论坛$读书 论坛$地方 论坛$英文 论坛等
庄主|阿尔多卡塞塞先生$如数 家珍地|介绍了 农庄的 发展史
固始县|武庙乡 黄岭村|一村民$在 河沟里|捕捉到 八条|娃娃鱼
如|打打 牌$搓搓 麻将$跳跳 舞$玩玩 保龄球$泡泡 网吧等
那|渔舍|岸柳 荷菱|鹅侣 鸭群$充满了|江南 水乡 情调
推进|反腐败 斗争$访|中央 纪委|常务 副书记|曹庆泽
他们 总认为$吃点儿$喝点儿$玩点儿
苗族 民歌的|爆破音的 运用$别有 韵味|委婉|动听
海南人$告别|野味 佳肴
离乡的|惆怅 噎 满腔$误为|理想的|惆怅 噎 满腔
将|八万 多卷|诉讼 卷宗$和|二千 多卷|文书 卷宗
布什 总统|宣布|美国 退出|美苏 签署的$反弹道|导弹 条约$简称|反导 条约
加上 他们家|原住房$出租 给|另一 廉租户$所得的 收益
寒冷的 空气|使|菲亚特 年会的 气氛$也不像|往年 那样 热烈
由于|逃税 骗税|走私 贩私$制假 售假|逃废 债务$六合彩 赌博 等|社会 丑恶 现象的|肆虐 泛滥
以及 采取|掺杂 掺假$以假 充真$以次 充好$短缺 数量 等手段
已从 过去的|铺铺 盖盖$遮遮 掩掩|洗洗 涮涮的|实用 功能
轻度 中毒$会造成|嗜睡$头疼$头晕$恶心$呕吐$胸部 紧束感
康家 营子|双井|古鲁|板蒿 等|三乡 三场|万亩 黄沙$得到 根治
现已 确定|由|新人|孙俪 来|扮演 安心$佟大为|扮演 杨瑞$何润东|扮演 毛杰
希望 他们 今后|着力|在$已 开发 项目的|应用上$多下 功夫
只要是|什么|庆典|剪彩$这些|轰轰 烈烈|热热 闹闹的 场面
也 关系到|工作 能否|顺利 开展$政令 能否|顺利|贯彻 执行
那里的|大漠 戈壁$草原 冰川$雪域 高原$江河 湖泊$古物 遗址
彭宜举|似乎 又 看到了|民意街 居民$万多双|焦虑的 眼睛
一边|扯开 嗓子$对着|市场上|熙攘的 人群$吆喝了 起来
考场|由 考生|随机 抽选$评委会|随机|抽组 试题
我们 必须|坚决 反对|讲 排场$比 阔气$奢侈 浪费的 风气
广泛 深入地 开展了|创建 文明 乡镇$文明 村屯$文明 单位$文明 家庭 等活动
从|广种 薄收$越种 越穷的|传统 耕作中$醒悟 过来的|延安人
萨福诺夫|转达了|伊万诺夫 外长$对|唐家璇 外长的 问候
国家 九五|攻关 项目$抗 恶性 肿瘤|转移 新药$转移停 胶囊
另一位 明星$广西 壮族 姑娘|黄秋艳$在|女子 三级 跳远 比赛中
很是为|忠诚|摄制组$为 纯洁 荧屏|语言 文字|所作出的 努力 赞叹
俄罗斯 体操 女皇|霍尔金娜$再夺|跳马|和 高低杠|两枚 金牌
人民网 相继 开通了|英文 网站$法文 网站$日文 网站$西班牙文 网站$阿文 网站$和|俄文 网站
汪洋湖的 老伴|和 子女$也曾 对他|有过 怨气|甚至 误解
仅|翁拱 寨户 人家$就有|先天性|痴呆 聋哑 等 残疾人|一百名
村总 电表|与 分户 电表的 差距$用 每户 每月|一千瓦时 变损 来弥补|绰绰 有余
郑成功|能 眼看着 薛娘$落入 敌手|遭其 蹂躏|而 熟视 无睹
其间 点缀|瀑布 石矶$小溪 雕花$踏步 跌水 雕塑|等 景点
那些|貌似 洒脱$实质 鄙陋的|京骂 方言骂|国骂$就会|失去 市场
可转换|金融 债券$储蓄 债券 等|债券 品种$也|备受 推崇
届时|将用 缆绳|通过 钻孔$把 库尔斯克号|牢牢 拴住
明白 不了|这个 连队$刚毅|豪爽|粗粝的|英雄 性格$何以 得生
我们党|才能在|各种 挑战|和|考验 面前$永远 立于|不败 之地
上诉 法院的 裁决$吹散了|压在|微软 头上的|分拆 阴云
穿梭于|四川 盆地$柴达木 盆地$塔里木 盆地$准噶尔 盆地
美国 经济|从|六月起$结束 创纪录的|年增长$而 陷入 衰退
导演 严浩$曾 执导 影片$滚滚 红尘$似水 流年$太阳 有耳等
刽子手|残忍地 挖出|阿贝尔 一只 眼睛$去|威逼 阿伊德
只 觉得|脸颊$眉毛$头发$湿漉漉地$挂满了 水珠
埋头 苦干$励精 图治$克勤 克俭$大胆 探索$勇于 开拓
立即 组织|两艘|艇载|高速 摩托艇$全力 追击
经常|反思 自我$解剖 自我$拷问 自我$完善 自我
哲蚌寺|当时|就 拥有|三座 庄园$万名 农奴
纽约|商品 交易所$一月份|原油 期货价$下跌了|四 美分
促使|邮政 业务$由 三足 鼎立$向|四业 并举|过渡
比如|鱼翅 月饼$鲍鱼 月饼$螺旋藻 月饼|等等
班禅 六世|率|两千 多名 僧众$登越|茫茫的 雪山
雅典 奥运会|与|北京 奥运会$要 一起抓
巴以|何时 才能 走出$冤冤 相报的|循环 怪圈
引导 和|帮助 未成年人|学法$懂法$守法$用法
宛传寿|杨述军|罗洪波 三人$因|盗窃罪 入狱
禁 拉|禁 拽|禁 蹬|禁 踹|冬暖 夏凉|不结实|不要 钱
黑人|民权 运动 领袖$马丁 路德金|惨遭 暗杀
老婆|气喘 吁吁|跑回 来说$到|七楼|皮肤 性病科
北京大学|东门外$有 数家|有 藏书的 咖啡屋
汉语 拼音 方案|包括|字母表$声母表$韵母表
农技 部门|答应 一年|为民 培育$多少 多少|公斤 良种
农民们|忙着|种花$种草$养鱼 养虾|养螃蟹 等
控制|和 缩减|沿岸 近海$和|外海的|捕捞 强度
省上 选择|并|命名了 五个$劳务 开发|龙头 企业
而且|还有|三名 中国 选手|分别 获得|第三$第六$和 第八 名
耶路撒冷|等 地 又|连续 发生 大规模 爆炸|袭击|和 交火事件
当场|将|二十九辆|被盗 机动车$发还给 失主
武警 安徽 总队 党委$坚持 用|好的 作风|选人
经过 党委|集体 讨论 决定的$仓库 周末|育才 学校|应运 而生
组织|尚未 取得|驾驶 资格的|二十名 官兵$利用 双休日|参加 培训
从而|避免了 使用|普通 电池|可能 产生的$污染 环境 等 问题
妻子|在|身体 状况|允许的 情况下$收拾|家里的 东西
辅助 生产 各种|修配|和|生活 服务$都由 企业|自己 配套
今年|青海 投资|三十亿元$加快 农村 电网|和|城镇 电网 改造
该局|所办 案件的|准捕 准诉率$均达|百分之百
把|存量 资产 返回$与 转变|职工 身份|结合 起来
婀娜 多姿的|顶碗舞$赢得|阵阵 掌声|和 喝彩声
阿根廷|乌拉圭 政府$积极 致力于|发展|对华 关系
发现了|该|犯罪 团伙 成员$非法|洗钱的 证据
帮助 高校 解决$作风 建设 方面|存在的 突出 问题
晚会 由|一路 春风$金曲 流光$儿女 情怀$三个 篇章 组成
也有|不少 作品$恰恰 表现了 一种|男尊 女卑的|陈腐 观念
感慨 万分地|写出了 一个|知识分子的$人 生命运
刘亮程$周晓枫$谢子安$李汉荣 等|都是 如此
一幢|漂亮的|二十层 高楼$在 北京|军医 学院 落成
严禁|印制 发售 购买|和 使用 各种|代币 购物券卡
印度 陆军的|各个 军$都将 派 部队|参加 演习
五十三岁的 周光裕$是|南京 钨钼 材料厂|下岗 工人
吸引|国内外 知名的|医药 企业$设立 高科技|研究 中心
要 把|国防|后备 力量 建设$纳入|法制化 轨道
小说 借|游丝般|纤细 敏感$而又 脆弱的|人物 命运
他们 在|许多的 石头 上$看到|超凡 脱俗 如佛的|天堂圣境
但|很多 厂商|半年前 制定的 计划$肯定 是|远未 完成
台湾 同胞$无论 是|台湾 省籍|还是 其他 省籍
旅行社|提前 七天$将|旅游 团队 名单|传送至|口岸 签证 机关
天津|二轻 集团 公司 领导$深入|困难 企业|困难 职工 家中 调研
当 金色的 阳光$洒满|秦晋 峡谷 间$湍急的 河道
这 故事|让我 惊叹$让我 愕然$让我 萌生了 歉意
陕西省委 常委|累计|下乡|下基层 调研$达 五 天
紧紧 围绕|加快 企业 改革|与 发展$这个|根本 任务
影响|双边 经贸 关系 发展的|不稳定 因素$依然 存在
制糖|和 纺织|两大 行业$实现 整体|扭亏 为盈
其|注册 资本|最低 限额$必须为 实缴|货币 资本
配额 持有者$未使用完 其 持有的|年度 配额的
几乎|全靠$遍布|大街 小巷的|大饼店|面包房 供应
要不要 为了|跨边界 购物$而到 银行|去 换钱
原|中共 江苏省|顾问 委员会 主任$柳 林 同志
董建华|在 演说中|表现 出来的|勇气$决心$胆识
兰州 金和 商厦$能不能 作为|破产 财产$被 拍卖
怎样 把 周刊$办得|更 紧跟 时代$更|贴近 读者
湖南省|韶山 管理局 副局长|肖友成$告诉 记者
从|八十年代 初期$当地 老百姓|自产 自销|绣花 枕套 床罩 开始
华宝斋|新近 影印 出版了$线装本 茅盾 手迹
上面|刻着 一 幅|观世音 菩萨像$及|一篇 佛经
巴政府|将|根据 相关 法律$回应|扎伊夫的 请求
让|铁路 沿线 居民$了解|防护 栅栏的|重要性
但在 本质 上$都与|丢掉了 艰苦 奋斗的|精神 状态
可|引起|鼻腔$口腔$鼻咽$咽喉 皮肤$和|消化道 癌症
随后|八一队 范斌|与|张劲松$外线|三次 命中
欧盟 领导人$奔走 于|大西洋 两岸$和|阿拉伯 国家之间
绵阳 境内的|三资 企业$已达|一百 三十七家
面前 一位|乌兰 乌德市|布里亚特 姑娘$名叫 奥琪
从|堆满|楼上 楼下$十几个 房间的|家具 杂物
他信|再次 强调了$泰国|欢迎 外国 投资的 立场
军费 预算案的|附加案$反恐怖 紧急 拨款 方案|总额 为|十亿 美元
其中 包括|与|糖尿病$肥胖症$小儿 湿疹$等 疾病|相关的 基因
护士|除了 给他|温水 擦澡|理发 剃须$生命 体征|监测外
当他|很快 察觉$我们 称呼他|总有点 磕巴时
此时的 周云天$后悔 不迭|当初 安装|设备时
桂花鸭 卤菜店$就|一定 能够|走出 困境|走向 兴旺
几个|光屁股 娃娃$又喊 又叫|在|洗衣 女人 前面 游泳
他要 提拔 沈阳市|客运 集团$原 总经理|夏任凡
天津|普利司通队$客场 击败|云南|红河队 后
要 坚持|国防 教育$与|群众性|双拥 活动|相结合
图为|民警|向 小学生$讲解 有关|交通 安全 常识
却 又|不停地$用 圆满|升天|上层次 等|歪理 邪说
名誉 副主席$李辰|田富达|陈仲颐|列席了 会议
今天|亲自 动手$把我 妻子|父亲|母亲|全部 砍死
福昌桥村 村民|王勋林$原是 有名的 贫困户
伯恩斯 二十三日晚$在同 黎巴嫩 总理|哈里里 举行的|会谈中 重申
深深 感到$两国|新闻 媒介的 交往$越来越 多
道琼斯 种工业 股票$平均 价格 指数|重 上点
后又 攒钱|买了 一个|嵌宝 戒指$作为 妈妈|五十岁 生日的 礼物
墨西哥 表示|愿 从|明年 起$将|原油 日产量|减少 万桶
据|新华社|斯德哥尔摩 记者$吴平|奥斯陆 消息
空政 话剧团|资深 导演|王向明$对此 却|颇有 信心
或者|终裁 决定$未确定 追溯 征收|反 倾销税的
万字的|藏汉文 宣讲 提纲$和|宣传 张贴 材料
孙毓霜$加入这 庞大的|旧体 诗词|创作 队伍
沉闷 已久的|纽约 华尔街$终于 奏起了|欢乐曲
济南|南部 山区的|卧虎山 水库|溢洪闸$缓缓 抬起
网民|最近 一年内$曾|通过 网络 商店|购买过 商品
房柱|屋顶|门窗 地板$都用 昂贵的|柚木 建造
省综委 要求|各市州$排出|重点 整治的|县市区
去年底 花钱|从|人贩子 手里$买回 一女子 为妻
但|分明 可以 感受到$多双 眼睛里|闪烁着 什么
一手 举伞$一手 捏着|橡皮 水管$踏上 木梯子
劫持|运钞车 等|犯罪 行为$必然会|大幅 上升
中远|安特|卫普号 轮船$从 厦门|海沦港 起航
虚报 浮夸|滥用 民力$盲目 攀比|强迫 命令的 问题
拜金 主义$享乐 主义$极端 个人主义$也在|滋长 蔓延
自从|受聘|北京 周报社$担任|改稿 专家 至今
要|吊销 其|勘查 许可证$并按|无证 采矿 论处
他们 要求|每位 干警$把|每起 案件|办成 铁案
记者 从|云南 边城|勐腊$驱车 向南$赶往|中老 边境
从|已被 挖出|攀登眼的|南内 城墙$爬上 墙顶
靠 城墙 内侧$分布着|纺纱厂$染布 作坊$面粉厂 等
墓坑 东侧的|坑底$腾起了|几十米 高的 火焰$和 浓烟
这些|可敬 可爱的 老将帅们$在 战争 年代|驰骋 疆场
竟然|明目 张胆地|搞这样$荒唐|透顶的 庆典
艾滋病|也不会 经|咳嗽$打喷嚏$蚊虫 叮咬 传播
本报|将|陆续 推出$九运会 前奏曲|系列 报道
还 带动|蒙牛|盘古 奈伦|等 乳业 企业$迅速 崛起
创作 出$纵横 天下|扬威 奋进|欢乐 颂|三幅 国画 组画
冈底斯山$喀喇昆仑山$慕士塔格山$隆起 祖国的 脊梁
刚刚|搬进 新址的|清涧 县委 机关 院内$热闹 非凡
欢迎|菲律宾 总统$格洛丽亚|马卡帕加尔|阿罗约
曾汉周|历任|红军 总部|特务团 二连$延安 警卫营 二连 司务长
爱上了 一位|风流 倜傥的 华侨$鱼食儿 脱了钩
这|两种 系统$将使|灵巧的|数字 信息|取代 繁冗的|书面 文件
顺着|隔离 栅栏$一溜 排着|六七个|卖 风筝的|男女 小贩
您 追随着 爸爸$在|上海|长沙 韶山|广州 武汉|到处 奔波
心儿 像 一只 风筝$随着 秋风|在它 上空|悠悠 飘逸
竹篾片|油毛毡 搭的 漏风屋$变成 清一色的 砖瓦房
只想把 死者|连同 死 本身$从|人们的 头脑中|一笔 抹掉
动起来$免不了 同|别的 东西|发生|磕磕 碰碰
百色 革命 老区|田东县$过去 长期|南旱 北涝
散打王 争霸赛$第二十八周 比赛|将|如期 举行
电磁波束$被|谷底|格朗巴桑村旁$呈 蜂窝状的|接收器 接收
所有 饮用|豆奶的 学生$体重 均有|显著 增加
幸而|踏踏 实实$肯 呆下来|用脚 来做 学问的|学者 还有
免去 客户|申请|一项 贷款$要跑 好几家|折腾|好多次的 烦恼
协和医院|弘扬$严谨 求精|勤奋 奉献的 精神
呼吁|全国 中小学 学生$提高 对|保护|臭氧层 活动的 认识
脾气 暴躁|性格 乖戾$孤僻 多疑|是其|施暴的 内因
李岚清 看到$蓝旗营 教师|住宅 小区|绿草 茵茵
越中 友协 副主席$范如刚 秘书长|武高潘 等
就剩|俺老师 一个$俺爹|让俺|跟 俺爷|看 承包的 菜园子
或因|种姓 不同 通婚|而|自杀$被杀$被烧$被 裸体 游街的
他因|不小心|掉进 地窖$摔坏 脊椎|落下 残疾
非得 让他|去找 附近的$商务 印书馆|碰运气
为|早日 平息 冲突$重开 和谈|创造|必要 条件
群山|仿佛 皆由|大大 小小的 碎石$堆砌 而成
如|三鲜 粉汤$羊血 烩粉$油粉$蒸饺$蛋粉 韭盒 等等
夏尔玛|使劲 用|自己的 指甲$猛掐|猴子的 脑袋
现任|海关 总署$广州|番禺 海关|海查科 科长
看一看|艺术 院校外|挨挨 挤挤$欲|闯入 殿堂的 学子们吧
粉碎了 王殿臣|企图 暗杀|李修凯$栽赃|葛怀新
服部茂|经常到|馆外的 遗址$给|参观者 讲解
无异于|触摸 人类$自身|赓续 绵延的|进化 脉络
并|由此 评出了|可爱 宝宝$超级 宝宝$聪明 宝宝|等 荣誉 称号
萝卜|白菜|茄子 辣椒|豆角 生姜 黄瓜$一古脑|切碎 汇合
吕梁|一改 往年|重建 轻管$喝|大锅水 之弊端
选用|什么 材料$他都|边 掰手指|边|娓娓 道来
咱们|当 干部的$要|想方 设法|为 他们|排忧 解难
还|指导 他们|挖 水渠$修 道路$平 土地$筑 田埂
这人$颤颤 巍巍的 走路
军情的 变化$让 毛泽东|揣着 草案|奔向 古田
此生|如能像|父亲 那样$勤勤 恳恳|兢兢 业业
曾|远离 苏州河的 海鸥$又|重新 飞临|苏州河
人文 情怀|探寻$北大 清华|赛艇 对抗的 奥秘
让|花骨朵$在|月亮 姐姐的 爱抚下$快点 催大
我|不爱|洗手 洗脸$上床 睡觉|蹬袜|就 钻被窝
日本 某些 势力$不仅 抵赖|对|战争|受害者的 赔偿
朱广英|抓起 消防 水龙头$把 自己身上 淋湿
打假|越打 越多$越打 越难$越打 越贵$越打 越险
钱其琛|首先 对|台湾客人的 来访$表示 欢迎
抢劫|出租轿车 六辆$微型 冲锋枪支|及|子弹 数发
归$塞尔维亚|克罗地亚|斯洛文尼亚 王国
压死 埋死$炸死 饿死$累死 冻死$病死的 矿工
把|血淋淋的 封建 统治史$当作|轻松 愉快的 游戏
陈棉|因|无法 实行|顺价 销售$而|仍要 储存 压库
打击|土炼油 专项 活动$虽然 取得|明显 成效
数百盏|大红 灯笼$和|上万盆 鲜花|笑迎 来客
向|当地 公安 干警$赠送|该公司的 产品$并|捐赠 现金
邰丽娜的|同父 异母 妹妹|陈丽娟$要求|参加 诉讼
感谢 袁熙坤$赠送 给|奥林匹克 博物馆的|精美 画作
王师傅|张罗着 买$刷房 用的 涂料
促销 活动$从|捆绑 软件|转为|捆绑 可乐
说什么|黄金$白银$未免|太俗气了
我们|清楚 知道$香港的|问题 所在
在|阿鲁 科尔沁旗$岗台乡 小召村
首盘 由|王励勤$迎战 瓦尔德内尔
频频 遭受|无聊 挑逗$粗言 谩骂|谎报 警情
它 始终|静悄悄地$藏在|大兴安岭的 北端
澳门 同胞$都|完全 可以|放手 去做
但|曹薰铉|打入 白空后$轻松 活出
看|足球赛 转播$也 离不了 遥控板儿
你就|这么 忍心$离开 我|和 你妈吗
突破口$选择在|中关村 聚集的 高校
因为他|魂绕 梦牵的|大森林$叶将 飘零
晾晒的 腐竹上$落着|许多 苍蝇
访问$反馈 结果|前条的 比率 达到
存多了 就好 买|本子呀$笔呀$书呀
由|古筝$如泣 如诉地|主弹 出来后
散发着$花花 绿绿的|商品 广告 传单
规章 送审稿$有|下列 情形 之一的
咱可 不愿|胡里 胡涂$闷坐 胡涂庙
好像|压根|就 没打算|让 读书人 买
王婆 商标$逐渐 被|消费者 所认可
招商 引资|和|外资 出口$成绩 斐然
特意|到|湘雅 医院|来 住院$保胎 治疗
堪称 我军|初创 阶段的$光辉 战例
任继愈 先生$宴请|香港|饶宗颐 先生
只听|怒吼的 狂风$一阵|猛似 一阵
为|骗税 分子|节约 骗税 成本$出谋 划策
萨比特|是$法塔赫 图勒凯尔姆省 书记
总之|群众 需要办的 事情$什么也 办不了
新莽 货泉上$王莽|悬针 垂露的|优雅 书法
美英 空军$对|阿富汗|实施|空中 打击
打起 铺盖卷$来到|黄狼 沟村|蹲点
涂片 显微镜 检查$发现|炭疽 杆菌
而|温凤勇$因|刀口 距 心脏|只有 两厘米
本可|丰衣 足食|快快 乐乐$过 一辈子
擅自 用 剪刀|剜除|彭敏$背骶部的 褥疮
孟彼德 太太$为什么|改变了 主意
应当 想想$是否会 干扰|邻居的 生活
买卖 双方|签订$虚假的|租赁 合同
最后 一句|本应 写$画坏|谁也 别要
有些 主持人|说起 话来$嗲声 嗲气
刘文功的 二弟$被 诊断出|肺癌 晚期
大量 废渣|还使|明月湖$淤积 湖水 变质
错将 除草灵|当成 敌杀死$给|秧苗 喷洒
台湾 当局 允诺$要|松绑|戒急 用忍|政策
农业 结构 调整$深层次 矛盾 突出
意思 为|毫无 用处他 顿时|被噎住
内心 深处|总会 感到$特别 温暖的
本来|就|当不 了衣裳$遮盖 山体的
铲除|腐朽 文化$赖以 滋生的 土壤
罗马尼亚的 萨博$在 旁边|偷着乐
居民|打开 水龙头$即可|直接 饮用
挽缰 牵马|走过了 六万里$漫漫 长路
所产 李子|个大 色鲜$浓香 爽口|耐储运
原本 需要$四个月 完成的|测量 任务
千万|别再干$捕杀 青蛙的 蠢事了
覆盖率|占 红树林$宜林 滩涂的 以上
认真|学习 领会|总书记的$谆谆 教诲
真理|都会 像|金子 一样$闪闪 发光
如|傣族$苗族$圭族 瑶族|卡姆族 等等
因|连续 忘我 工作|十小时$疲劳 过度
短短|半个月$非法 罚款|两千 余元
被|扮得|呆头 呆脑|傻里 傻气$没见过 世面
雷洁琼$痛恨|北洋军阀的 腐败|与 蛮横
非行 行长|卡巴杰$发表|简短 讲话
珠海|去年 港口 货物|吞吐量$达 万余吨
给|人类 精神史$审美史$提供|新的 素材
但|身着|摄影服的 冯刚$精神 抖擞
其实|他|并不 喜欢$吃 这种|泡泡糖
南海的|万顷 碧波$卷起|亿万朵 白浪花
爷爷|奶奶|姑姑 叔叔$对他 也 很好
羌西北 无人区$泥沼|与 湖泊 交错
可|刚满月的 小囡$才|真让人 够呛
但|又要让|外边的 人 知道$我很 坚定
如|母亲|代 女儿 怀孕$姐姐|替妹妹 怀孕 等
累计|销毁|假冒 商标 卷烟$余万条
把|边学|边改$边整|边改$贯穿 始终
噢 开镰喽$这 喊声|借着|回旋的 山音
脸上|笑靥 盈盈$与|扁担 弯弯 齐律
顾客们 全都|七嘴 八舌地$问 售货员
猪$狗$猫$兔子$狐狸$乌龟$熊猫 等 词语
无公害 蔬菜|推广 面积$达|六万 多亩
好几年 没这样$痛痛 快快 过年了
球|竟然 擦着 门楣$飞入|本方 球门
有|休闲 服装$休闲 皮鞋$休闲 旅游
扩展为|三个 新闻 频道$五个|专题 子网站
而|帮他 夺冠的$窦阳|惠国 等人|似乎 比他|还高兴
国安队 徐云龙|接到 王涛的|传球$巧射 得分
这套 战役$后方 仓库|搬运|系列 设备的 机械
良好的 软硬 环境$吸引了 众多的|外来 投资者
办事处|还 停止了 在|飞机 客舱内$配置|金属 餐具 刀叉
在|各类 商店 中$查获 用|黑心棉 制成的$棉被|棉垫|棉褥
更好地 为|中小 企业$提供 各类|信贷|和|融资 服务
而|当地的 行业的 报纸$倒 真是|放在了 首位
大家|眼睁睁地 看着 陈涛$与|持刀 歹徒$殊死 搏斗
在|改制 时$把 这一块|返回给 职工$引导 职工|转变 身份
在 企业中|形成|联社 参股$职工 控股的|股权 结构
冷水 江路段$成为|株六 复线 湖南段$贯通|最早的 路段
这一年|我们 还高兴地|读到了 一些$中青年 散文家的 好散文
外资 金融 机构$应当 按照 规定|计提|呆账|坏账 准备金
元旦|春节 期间$加强|廉洁 自律$反对|奢侈 浪费
全路 运输 从业 人员$从|去年末的|万人|减至 百人
市里|对 矿务局$减免 收费|支持 资金|近 亿元
给|对方的 中学$送去 急需的|电脑|和 扫描仪
将在 谭利华|与 韦尔纳$安德列$阿斯$阿尔伯特的|轮流 指挥下
一名|失业 男子|通过 网络$查找|合适的 工作
当|同方 电脑|挂着|清华的|大招牌$猛攻|教育 系统的 时候
在|联想 电脑$跟踪 老年人|上网 需求|细分 市场时
秦 兵马俑|赴台 展览$同一首歌|中华情|赴台 演出
张沙鹰|向|萨阿 总统|递交了$江泽民 主席的|贺信
一是|省委|省政府|率先 压缩$报刊 内部 资料
查处了|交通 时报$温州 晚报|等家 报纸的|违规 问题
也可在|旅游团|抵达 口岸前$提前 做好|签证|交 旅行社
将|港口的 疏浚费$和|港口 装卸费|分别 降低
潮阳市|金玉镇|外洋村|虎山 脚下$彩旗 飞扬|鼓乐 喧天
四处 迸射的|玉色 水沫$张扬着|瀑布的 激情
敦厚的|地瓜片$土豆片$以及|酸菜|生菜|香菜 等等
关井 压产$促进了|煤炭 生产 结构的|调整 优化
各地|调整 整顿了 一批$软弱 涣散的|后进 班子
都是|普通 农民$无需 专门 训练$便可 参加的
高度 评价$俄|国家 杜马$批准|中俄 睦邻|友好 合作 条约
特别 要|关心 那些$最 困难|最 需要|帮助的 群众
印度 指责|巴基斯坦$扩大 对|印军的|炮击 范围
努力 确保|外贸 进出口 总额$不低于|今年的 水平
违反 本条例 第十二条|第二款$第十六条 第二款 规定的
今天 又以|两小时 五分的 成绩$率先|抵达 终点
在|中国网的 平台上$构建|网上 中国|百科 全书
福州 厦门|定点 屠宰场的|生猪 瘦肉|精检 出率$大幅度 下降
印着|今日 吉凶|神仙 方位$猪冲 蛇|狗冲 龙|等|荒诞 内容
以|食品 药品|农业 生产资料 棉花$和|拼装车 为重点
东部 生态|科技 片区$低密度|组团式|生态化的 规划
战友们|清楚地 记得$李兆林|为他们 做的|点点 滴滴
这 一切 辉煌|连同|赵佗的 显赫 功业$都被|历史的 长河|卷走了
只见|万人城 脚下的|连江 浈江 二水$汇成|汹涌 江流
车子 会把|这家 餐厅的|方位|和 特色$介绍 给你 听
产妇|和 四胞胎$在|平壤 产院|住院 期间|所用的 医疗费
对于|离婚 中|无过错方$行使|损害 赔偿|请求的 权利
则|该项 请求$必须 与|离婚的 诉讼$同时 提出
其次 是$规范|和 加强|区域 贸易|组织的 发展
东兴镇|党委 副书记|缪红卫$牵头 成立的|鹌鹑|养殖 协会
一连 三天|在|春熙路$青年路$暑袜街$染坊街 等地 转悠
民族 日报 援引$英国 驻肯|高级 专员|克莱的 话说
以上|水果 外包装$均|乱打|绿色 食品|商标 标识
为|政府|科学 决策|提供 咨询$当好|参谋 助手
世界 篮坛|头号 巨星|乔丹$发表|第二次|复出 声明
这是 陈贵俊$在|精心 打扮|自己|心爱的 家什
发现|昔日|吞云 吐雾的|石灰 窑群$彻底 消失了
户 重点 企业的|快速 发展$拉动|全省 工业 经济|增长|八个 百分点
沈铁梅 演唱了|天天 有气|气 难舒 那段$迂回的 旋律
然而|它 仍然|充分 显示了 原著$强烈的|悲剧 精神
做到|选优 汰劣$优进 劣出|好中 选优$保持 常数
特区 政府|采取了 一系列的$短期 措施|纾解 民困
不然|我就|阴魂 不散地$跟着你
国家|有关 部门|应下|更大的 力气$抓|殡葬 改革
因|眼压 高$并发|白内障$角膜 水肿 等|而 导致 失明
记者 找到了|豫皖 交界处$这间|低矮|破旧的 平房
是她|率领 刘胡兰 战斗连$率先 跳入|滔滔 洪流
朝鲜半岛|朝韩 双方$保持了|接触 与|交流的 态势
对|报装 报修|电费 查询|咨询|举报|投诉等 业务 流程$进行 重组
只好 跟着$每月|只有|几元 退休金的 外婆|度日
笔者|就曾|亲眼 见过$某某 服装|批发 市场里|放了 牛羊
中亚|南亚$是|经典 陆权 理论|描述的$欧亚 板块 接合部
这是 对|邪教 法轮功 宣扬的$真善忍的|极大 讽刺
并 提议$让 约旦|派 两架 直升机$送他 去|伯利恒
中国 画坛$果然是|画栋 雕梁$七彩 敷陈$典雅 精微
驻军 某部的|部分 官兵$承担了 小聪儿|全部的|学习 费用
并给|出版物的|差错 认定 工作$带来|诸多 麻烦
市政厅内|蓝色 大厅|宽敞的 台阶$成了|很好的 舞台
即卓娅 牺牲地$佩得里谢沃村|解放的 当天
利用|高能 射频 集束刀$治疗|左肺癌 肾上腺 转移
北有 岳阳楼$桃花源$屈子祠$张谷英$明代 古村落
长沙|湘潭|株洲 三市$联合 推出|红太阳 之旅|主题 活动
公平 竞赛奖$授予|红黄牌 最少的|辽宁 抚顺队
到|痛定 思痛|大段 念白$引出|怒沉 百宝箱的 唱腔时
参赛 车手|将 使用|中国 汽联|统一 提供的$三菱 蓝瑟 赛车
使|准 爸爸们|了解了|护理 婴儿的 一些$基本 知识
巩晓彬|和 外援|洛兰达斯$对抗|巴特尔|同 乔治
也许 就|不会 眼见|铿锵 玫瑰$凄然 凋谢的|伤感 一幕
以|严肃 认真|负责的 态度$发表 言论|和 处理 此事
烫 熟了|放到 碗里$加上|汤 和 香菜|就可以 吃了
对|封建 官场的|司空 见惯的|贪墨 歪风$尤其是|疾恶 如仇
慕绥新|为 刘宝印|减免了$数百 万元|工程 项目 税费
甚至|多次 同|宁先杰|李经芳$偷偷 飞到|境外 赌博
穆沙拉夫 总统的 夫人$名叫|赛赫 巴法端德
决定|由|县审计局|对 财政局$依法|进行 审计
许多|认识 老杨的 人 都说$老杨|是 累死的
后来|妻子 和 儿子$偷偷 买回 一台$三十五 英寸的 彩电
密切 关注|和 分析$入世 对|财政 收支的 影响
肮脏的 粪便$变成了 主要 成分|是|腐殖质的 有机肥
其中|千亩 泥蚶|围栏 养殖|示范 项目$亩产 泥蚶|二百 公斤
在|嗷嗷 惨叫 声中$正 准备 运往|农贸 市场 时
改烧后|一年|可减少 排放|二十吨 二氧化硫$十吨 烟粉尘
我国 法官|偏低的 待遇$与其 身份|极不 相称
体现|办案的 法律 效果$与|社会 效果的 统一
开展|人工 驯养 梅花鹿|和 麋鹿的$野外 放归
而|低山$丘陵$平原$滩涂$河湖 兼备的|地貌 类型
聪明的|盱眙人$在|龙虾节 背后|藏着|文化的 伏笔
加上 处在 受$反动派 迫害|和 围剿的$客观 环境中
嘟 伯|嘟 伯的|袅袅 歌声$仍在 剧院的|上空 回荡
很多 学生|经常 爱到|个体 摊点$和|校园 周边|餐馆 吃饭
沙河口区$李家 街道$锦霞 社区$创办|小巷 讲坛
费尔霍夫 施塔特$在|首脑 会议后的|记者 招待会上 表示
上门|为其 办理|无需 担保 抵押的$农户 小额|信用 贷款|九万元
我又 找|喉咙 要害的|地方 砍$我 往回|拖 我妈的 时候
大批 用户$实际上 已经|主动|从|模拟网|转到 数字网
顶灯 计价器|防护网$监督卡|车牌 等|样样俱全
一对|白发 苍苍的|老夫妇$踉踉 跄跄地|扑进来
福建省|信访 系统$强调 建立 健全$完善 信访|接待日 制度
切实 增强$做好|城市 民兵 工作的|责任感$和 紧迫感
对|激励|广大 青少年|刻苦 学习|勤奋 工作$开拓 进取|奋发 成才
但 我|久久 追求 这种|浩渺$苍凉$悲壮|而|深邃的 境界
蒲甘 市民|在|蒲甘 最|古老的 佛塔$瑞喜宫 佛塔旁
导弹 部队|火热的 生活$是|开掘|军旅 雄浑 大气|之作的 热土
在|海拔|近万米$通往|某 哨所|逶迤 延绵的 山路上
小品|女兵 王燕$在|中国 曹禺|戏剧奖|评选中 折桂
奋力 追赶的 感觉$比|被人 追赶的 感觉$更有 压力
师傅 用|几分钟的 时间$更换了|钉书钉 大小的|导电膜 后
你都|可以 看到$日本 产品的|专营店|专修店
很快|深邃|陡峭的 莲花沟$就像|蒸汽 火车的 喷气口
被|老谋 深算的 曹薰铉$以|一着 妙手|便宜了 两目多
并|规劝|打电话的 学生 家长$为了 孩子|忍了 算了
托拉 博拉 地区的|武装 分子$较早时 曾表示
毛主席|品尝 他们|烹制的$蜜汁 火方 等|扬州 名菜后
两名|缅甸 女青年$向|江主席|和 夫人|王冶坪|敬献了 鲜花
在|经历了|消亡$瓦解$整容$抵抗$或 坚守的|阵痛 之后
样册中的|无彩 色系$由|白色|黑色|和 灰色 组成
一些|党员 干部|批评 自己$怕|失威信|丢面子
没有|共产党 培养的|吴天祥$和|吴天祥 小组
邻近|龙港镇的|七间楼村$还属于|较贫困的 农村
两年 多来$改革|之所以 能取得|突破性 进展
敦煌 壁画|麦积山 石窟$早已 成为|炎黄 子孙的 骄傲
而|卖|树仔菜的 运销商$也是|一肚子 苦水|没处倒
省长|赵乐际|针对|机构 重叠$办事 扯皮|效率 较低的 问题
巴西 前总统|科洛尔$因|洗劫 巴西|而 被弹劾
在|刚装修 完的 室内$点蜡烛 除味儿|更是 行不通
汤普森|在去 马来西亚|度假时$神秘 失踪了
姑娘 用 眼泪$溶化了 捆绑的 绳索$得以 脱身
没有|挽狂澜 于|既倒的 侠客$叱咤 风云的 老大
体坛 将有|冬奥会$世界杯$足球赛$亚运会 等|大型 赛事
赵某|原先 所在的 单位$还 专门|出具了 证明
但 照料|孤寡 老人|陈婆婆的|光荣 传统$却|传了 下来
喀麦隆|公共 卫生部长|于尔班 奥朗盖纳 阿沃诺$十九日 宣布
丛书 分为|寻找 魔鹿$寻找 猴国$寻找 香榧王$寻找 相思鸟|四本
潮剧 葫芦庙$越剧 洗马桥$歌剧 司马迁的 改编|也都 穿透 历史
它以|说 孩子话$让 孩子 说话$为 孩子 说话|为 宗旨
工商 银行 发行的|牡丹 灵通卡$发卡 数量|已经 突破|一千 万张
同样 直径的|高温 超导 材料$和|普通 铜材料 相比
从|田间 收来的|苜蓿草$经|高温 烘干|和 压缩
捕捞 一种|堪称 水黄金的$珍贵 盐湖 资源|卤虫
他|正在 棚地上|挥舞 镰刀$割|齐 腰高的|紫花 苜蓿
又有 现代戏|华子良$她从|雪山 走来$草原 母亲等
作品的|画面 构图$光影 营造$色彩 呈现$以及 故事的|起承 转合
其中|盗伐 滥伐|林木 刑事 案件$同比 上升了
终于|在 台湾的|骨髓 捐赠 中心$找到了 相配的|骨髓 供体
一双|智慧的 眼睛$透过 那副|白色 眼镜|炯炯 发光
韩国|刘昌赫 九段 执黑$以|三目半|大胜 日本的|中野 宽也
账面 金额|八亿元的 资产$分|四个 资产包|参加 招标
四周 流淌的 鲜血$燃烧的 烈火$和 人们|雄壮的 呐喊
朵朵 白云|都有 那|美妙的 寓言$握住 我的 手
孤零零地$不再 受宠|状态的 遥控器$于是|闹起了 别扭
他们 获得了$含有|五个 细胞的|人类 早期 胚胎
憋足劲的 辽宁队$在|决赛 中|以|零比一|输给 广东队
兵强 马壮的 辽宁队$轻取|缺兵 少将的|上海队
秋季型 人$拥有 一双|沉稳 温柔的|褐色 眼睛
一个个|简易的 帐篷$一件件|灰头 土脸的|唐三彩
比如|血压高者$必须 将|血压 降到|正常 水平
永乐 大钟 上的|梵文 经咒$属于|蓝蹉|尼泊尔 语译 音体
珠江 三角洲的|地缘 优势$是否 成了|明日 黄花
这|盗版书|虽说 漏掉了|稿费$编审费$等等 费用
确认 空难|系$跑道上 一块 金属片$割破 轮胎 造成
例如 打手机$酗酒$打架$冲撞 驾驶舱$侮辱|空中 乘务员 等
多渠道 地 筹集$群防|群治 队伍 建设|所需的 经费
东西 长|二十多米$南北 宽|五米$深|十多米的|巨大|露天 墓坑
随行的 包括|北方 联盟内$一些 派别的|高层 官员
学校|一直 坚持|面向 海外$面向 港澳的|办学 方针
让|错焦了的|爱情戏$远离 我们|健康的 荧屏吧
建立 起|补助 学费|减免 杂费$及|奖学金|贷学金 制度
简简 单单 一句话$蕴含着 数不尽的|喜怒 哀乐
您知道|最好用的 热轧板$是|哪家 生产的吗
东海的 龙须$南山的 麟角$老君的 仙丹$王母的 蟠桃
四川 宜宾|蜀南 竹海 风景区$晴转 多云
地处 黄河 北岸的|化隆县|群科 园艺场$总面积 一千亩
最先 触壁的 解放军队$因|单莺 抢跳|取消了 成绩
此次 访问$增进了|我 与 五国的|相互 了解|与 信任
自卖 自夸$这句|妇孺 皆知|又|朗朗 上口的 俗语
空灵 剔透|明亮 爽快$而|又有|神秘 奇特的 力量
加拿大|声明$将|执行 争端|解决 机构的 裁定
练就|狠 硬 快 猛 活$和|不骄|不躁|不馁的|战斗 作风
学习他|谦虚 谨慎|联系 群众$鞠躬 尽瘁的|高尚 情怀
这次 修改$也把|数据库 列为|受保护的 客体
结果|砖砌体|因|超载 失稳$而致|整座 楼房 坍塌
大宇|之所以 能把|瓷器活$干得|漂漂 亮亮的
同时|还|安装了 各种|泛光灯$射灯$轮廓灯$霓虹灯 等
这里的 工人$可能|真的 要对 党|失去 信心了
汽车 沿着|无定河的 一条$纤细的 支流|颠簸 前行
与 刘赶三|患难 相交$共话 白头的|贫家 女儿|秀姑
家乡的 老街|应该 说|富庶了$豪华了|气派了
与 选民|或|选举 单位$保持|经常 联系的|只占|百分之十
代表|曾经|督促 检察院 法院$纠正|冤假 错案
新建成的|解放桥$夜间 万盏 彩灯|璀璨 夺目
再如 路雪|在|火车上|遭到 三流氓$骚扰 猥亵的 描写
得知|我们 此行$是向 印度|发达的 软件业 取经
只要 一看|煞费 苦心 推出的$耀眼 醒目的|特写 镜头 介绍
整天|纸醉 金迷|花天 酒地$沉溺 舞池|歌厅 麻阵
产科 刘俊涛 大夫$在 一旁|轻声 哼起了|京剧 唱段
更 没有|装模 作样$花言 巧语$弄虚 作假的|市侩气
鼓楼|区委 书记|叶皓$亲自 做她的|转化 工作
敲打着 小巷|石板路的 光阴$天边 只余|一抹 夕阳
任 皮鞭|压杠|老虎凳|竹签$在您那 女儿 身上|疯狂地 肆虐
您才 忍心|抛下 所有|爱您的$和|您 爱的 人
经济|困难的 谭某|和 唐某$四处 奔走 两个月
那|酒|不至 烂醉|菜 不吃个 腻味$可能是 不会|善罢 甘休的
人们|对你的 信任 拥戴$有无 水分|有|多少 水分
这次|韩叙 准备的 菜单|有|烤鸭$炸 牛肉丝|炒面 等
密密 麻麻|记载着|官兵们 几年来$给|小兴驰的|二十次 捐款
打折的 书摊前$总是 围满了|认真 挑书的|热心 读者
筛选 出|优良的 植物 种子$和|微生物 菌株 等
彭敏 之母 李银秀$哥哥 彭亮$每天 给|彭敏 播放|法轮功的 录音
孙中山 先生的 亲属|孙穗瑛$孙穗华$孙 国雄
先后 到|德阳$绵阳$阿坝$雅安$甘孜$和|成都 等地 考察
位于|价格|垄断 地位的 酒店$在 弥补|亏损 后
很难|看到 农民$挥镰|扶犁|挥汗 如雨的 景象
辛亥 革命 志士|熊秉坤 之子|熊辉$登台 亮相
为 保证|十一 黄金周 期间$来昆 游客|吃得 放心
被 人们|亲切地 称为|陈赓 兵团的$娃娃 剧团
伪造|假现金 支票$假合同$假发票$假验收单 七份
如果|今后 一些 运营商$还是 这么|单打 独干
如有|发烧 头痛|恶心 呕吐$颈项 强直|皮肤 粘膜|淤斑 等 症状的
弥漫着|令人|怅然 若失的 隐痛$和|淡淡的 忧伤|很显然
铁锤|凿子|电钻|电锯$震耳 欲聋的 敲击声|令人|难以 忍受
枯燥的 讨论会$开成了|心情 舒畅的|神仙会
养血美|由 西洋参$阿胶$铁|三种 原料 为主 制成
来访的|非洲 国家 外交官$普遍 感到|收获 很大
指着|屋旁|树旁$横七 竖八|显得 很凌乱的 电话线
当|怯懦的 女儿|抡起 菜刀$砍掉 自己 小小的 手指时
随时 调整|各种 报酬$在|报酬 总额中的 比重
谁知|当夜 盗贼|把|待客的|鸡鸭 鱼肉$扫荡 空 有
他就 约请了|冯亦代$董乐山$施咸荣$董衡巽等|英语界 学者
九寨沟 景区内的|七百亩 耕地$已|全部 实现|退耕 还林
还|拿起 店前的|铁腿 饭桌|铁椅$追打|小郭 兄弟俩
歹徒|掏出 一把|十多 厘米长的 弹簧刀$吼叫着
定期 储蓄 存款|增加 较多$表明|储蓄 存款|稳定性 增强
已被|拆改得|面目 全非的 名宅$马中选 故居
摩托车|就|扬着 轻烟似的 灰尘$悠悠 然地 回村了
赤裸裸的 贿赂$有意 无意的|渎职|徇私 舞弊 等等
孙蒲云|看中了 元谋$得天 独厚的|气候 资源$和|无污染的 环境
她随 医疗队$到|兵团|农八 师团场|了解 病情
除|该 网站|及|台湾 几家 网站$为|中文 页面 外
他们 克服|高寒 缺氧|荒凉 寂寞$自然 条件|恶劣等 困难
奈良 药师寺 主管|高田 好胤$着手|筹资 兴建|玄奘 三藏院
拉拉 杂杂|谈了 几次$买书|补牢|调换的 经历
养精 蓄锐的 许姗$在|蛙泳的 较量中|超过了|日本 选手
主张 红军|应|集中|一切 力量$潜入|敌人 之远 后方
此塔的 价值$显然 超越了 礼佛的|原始 意义
郭老 还说$穆桂英的 台词$我 不挂帅|谁 挂帅
北约|三日 决定$向|马其顿|派遣 一支|一千人的|维和 部队
主管 教育的|乡党委 书记|罗怀众$对此|非常 苦恼
应将|马克思的 价值论$与|财富论|统一 起来
用|东借|西凑 来的|三万元$买回 一万株|刺槐|榆树苗|栽满 沙海
把|贫穷的 官店$带入了 全省|百强|乡镇的 行列
而|吃过 小米|住过 窑洞$扛着 红旗|闯 世界的 人们
他对|安哥拉 政府|重申|卢萨卡 协议 有效$表示 满意
关于 党的|最高 纲领|和$最低 纲领|相统一的 观点
如果|老伯伯 老太太|早上 练 太极拳$晚上 散步 之余
自我 解剖$违纪 违法|堕落 犯罪的$惨痛 教训
采用|反租 倒包 形式$收回 农户|承包地的 做法|有所 增长
就是|软绵绵$白塌塌$灰蒙蒙的|伪情调 伪趣味
我 写作的|那间 屋子$像只|闷头 闷脑的 大葫芦
沙枣树 红柳|很密 很密$在|树丛里|拐 几个 弯儿
远不是 凭某些|小机灵|小花样$能够 奏效的
弟弟 弟媳$多次 请他 出面$把 侄子 调到|分区来
站着 讲话$不会|双手 颤抖得$无法|捧读 讲稿
赖昌星|帮|他人 走私时$明码 标价|收取|通关费
哈轴 掉进了|人心散$管理乱$欠账多的 陷阱
成了|全村|上上 下下$老老 少少|盼望的 喜事
本着 谁借款|谁受益|谁还款$谁承担 风险的|偿债 原则
这也是 一次|以|长征 精神|拍摄$重走 长征路的|精神 之旅
他 摇晃着|油漆 剥落$铁栏 锈蚀的|楼梯 走廊 说
由于|耕种的 土地 是|三跑田$跑土|跑水|跑肥
金永南|是应 柬埔寨 国王$诺罗敦 西哈努克的 邀请
包括|田亮$王天凌$郭晶晶$桑雪$梁小桥$胡佳$张 晶
老农 手里|拿着 一个 沉重的$长把儿|圆形 扁铲
不愿 新闻界|早早|给 萨维奥拉$戴上 高帽子
吐鲁番|气象台 台长 陈春艳$向|记者 介绍说
该书中|陈独秀$毛泽东$周恩来$朱德 等的 传记
现在 爱吃|米饭 炒菜$和|面粉 做的|饼子 和馒头
厂区|一改 过去|黑烟 滚滚|粉尘 扑面$气味 难忍的|尴尬 局面
记|陕西省|凤翔县$糜杆 桥镇|原党委 书记|梁振宇
他们|舍不得 花钱|去|吃一顿 夜餐$住一宿 旅馆
布日敦嘎查$蒙古族 歌手|演唱的 一首|蒙古人
胆固醇斑 溃烂$是 引发|局部 缺血性 中风的|主要 原因
而且 附有|汉藏英 书名 索引$和|编著者 索引
齐刷刷地|把票 投给了 黄玉奎$和他 领导的 班子
寻访|曾经 保留了|革命 火种的$琼崖|革命 根据地
创办|苏迪曼 杯赛的|印尼|倾全力|拿下了 苏 杯
但你|却 应该|眼含 热泪地|欣赏 他$拥抱 他$赞美 他
印尼队 前锋|库尔尼亚万$获得 几次|扳平 比分的 良机
高粱 米粥$玉米面 大饼子$能 吃饱|已 很满足
听说|一花卉 基地|想请 某明星$给|吆喝 一声
重点|对口 扶持|郧西$通山$五峰$咸丰 等|四个 特困县
有的 建议|将|姘居$通奸$嫖娼$乃至|婚外情 等
哈达姆|感谢 中方的|盛情 邀请$和|热情 款待
可 挂号处里|冰冷的 声音$肯定 令你|心火 猛蹿
把|全班 同学|铅笔盒里的 橡皮$都|悄悄 拿走
种田的 把式们$望着|囤尖 仓满|卖不上价的 粮食
农庄|还饲养了|三头 母牛|六头 奶牛$六十只 绵羊|和 山羊
等她|跑车 归来$还要 拖着|极度 疲惫的 身子
灯 火|塘 火|篝火 烟火 火把$连 整个 片子的 影调|也是 火红的
以及|瞎蒙 乱猜$悲天 悯地$顿足 长叹的|精彩 景象
有|映山红$照山白$锦带花$白头翁 等|数十种 迎春花
你的 幼子|真真 切切$盼望|骄傲的 爸爸|亲抱
鸡呀|鸭呀|冷的 时候 还往 一块儿|挤一挤|靠一靠
强迫|数名 妇女 卖淫的$犯罪 分子|游德康
收缴|和 销毁|制假 原辅料 五车$烟丝 十吨|咀棒 一百 多件
遵循|长期 共存|互相 监督$肝胆 相照|荣辱 与共的 方针
里斯本|葡萄牙 共和国 总理$安东尼奥 古特雷斯 阁下
农嫁非 妇女$招婿 上门的 妇女$离婚 妇女$丧偶 妇女 等等
鄂北 岗地上的 农民$祖祖 辈辈|啃 包谷|吃 红薯
冬子|和 胡汉三|以弱 斗强$捉迷藏似的 情节舞
杀气 腾腾地|挑唆|哄骗 痴迷者$以身 护法$以血 护
批准|泰爱 泰党|党魁 他信 西那瓦$任|泰国 总理
翻地|给 棉花|打 农药$给|玉米 除草|归期 到了
飘飘 洒洒的 瑞雪$悄悄 染白了|秀丽的 峨眉山
男孩 曹威$朗诵了 他写的 作文$我 最喜欢的 节日
看看|这些 答题|过硬的 官$是否 行动|也 过硬
商标|续展 申请|被|驳回 后$申请|复审的 申请
是|该镇|最北端|绝崖上的 一座$高耸的 灯塔
类似|巴雅尔|吐胡 硕嘎查的$偏远 农牧区 很多
风水 先生的 老祖宗$是|只看|死人 阴宅的 风水
不少 农家|办丧事$都要|请 他们|去|吹拉 弹唱 两天
扭转了|近年来|顺差 不顺收$或|顺差大|顺收小的 局面
贯彻$解放 思想|实事 求是的|思想 路线
他们|怒斥|风险 资本家的$残酷 和 冷漠
剪刀|推子|梳子 等 行头$成本 低廉
黎雄才|对|坚韧 顽强的 松树$情有 独钟
使|波兰$从此 开始了|团结|工会 时代
偶然 可见|一两块|碎陶片$板瓦|筒瓦
留下了|艺术 生涯中$一串串|跳动的 音符
我 逛商场的 时候$碰上了|傅怡彬 夫妇
专门 对付$致癌的|明确|生化 缺陷
一堆 篝火$便|噼噼 啪啪地|燃起来
遭|两名 持枪 匪徒 抢劫$并被 杀害
哦 哈哈|一片 笑声$在|秧田里 响起
除了|台北 捷运$采取|短暂 停驶外
过去|是|迎送 太公$求神 拜佛 盛行
邪恶的 幻觉$必定会 产生|邪恶的 后果
就像 孙悟空$钻进|牛魔王的 肚子里
奥姆 真理教$已有 七人|被|判处 死刑
通过|减少 审批 事项$缩短|审批 时限
这个|过去|抢劫案 频发的$治安 死角
常昊 果断地$将|上边 两块|黑棋 分断
是|各|高等 学校$责无 旁贷的 责任
济南 降雨量|比 常年|偏少|七毫米 左右
开赛 前|匆匆 由|润迅 转手的$易康 男篮
外面 摆着的 棺材$是|质量 比较 差的
这一|凝聚 民心的 举措$值得 肯定
助长 党内|歪风 邪气的$滋生 和蔓延
我|黑色 眼眸$与你 蓝莹莹|目光 交接
保存 有|大量的$档案 资料|目录 信息
民警|巡逻的 频率$比 以前|大大 增加
哪知 这时|他 披着 雨衣$从|外面 回来了
空间|依然 飘洒$不断线的|绵绵 细雨
百万 富翁$纯粹 以|巨额 金钱|为诱饵
要么 是$垃圾 遍地的|干涸 护城河
涉及|花样 滑冰$棒 垒球$马术 曲棍球 等
奖金 来自$在法|华侨界 人士的 捐赠
同样 也|追求 美$表达 爱$抒发 真情
米色的 布面$错落着|暗黑的 色斑
称赞|她为|苏绣 文化$赢得了 声誉
增强了|与我 合作的 信心$和 决心
枝枝 蔓蔓地$插在 喝水的|玻璃杯 中
青草 牛粪$代表|真正的|乡村 味道
徐向前$受|中央 军委 派遣|赴|鄂东北
他一直|念念 不忘|虎跳峡$水利 工程
急忙 跑出去$搀扶着 李大爷|上台阶
看|赵蕊蕊 长得$高高 瘦瘦的 身材
明显|缺乏 追求$更高|更快|更强的 动力
欧洲 警察$向他 伸出了|大拇指
怀着|扬我 国威 军威的$神圣 使命感
于凤升$王刚$邢春$和|刘雅琴$为 副书记
享有|神窟 仙宅$灵异 之府的 美誉
某些 医院的|耳聋 专科$是|承包 出去了
顺德市 陈村镇$永兴|中兴 厨具 五金 厂
我们 从$爸爸|凝望着 窗外的 眼神里
这是|六安 市委$为|疏通|任免 渠道
河南的|开封 盘鼓$也 敲得|粗犷 豪迈
防洪 蓄水|降解 污染$均 具有|重要的 作用
秦汉 大赞|陈的 嘴唇$很软 很舒服
上午|杨影 迎战|河南 女队$帖雅娜 时
零售商|从|批发商 那儿$把 手机|拿来 以后
它 玩弄|造谣|诽谤|诬蔑的$无耻 伎俩
并 通过|交办$催办$督办$查办的 形式
空调器$电冰箱$微波炉 等|多种 产品
村民 推选|召集人$主持 罢免|四村官
马华|蹦蹦 跳跳$还 高声地|喊着 口令
亏损 企业|亏损 减幅$已|接近 于零
抗虫棉|在 省区$已 获准|商品化 生产
再加上$编者|通俗 易懂的|中文 说明
三相|共缆 电压|达 千伏的$跨湖 电缆
内坦亚|恰恰 位于$最 窄短的|中腰 地带
轻松 自在地 散步$听 音乐|赏 歌舞
心中 却$翻腾着|甲午 战争的 狼烟
古格 王朝|神奇的 勃兴$与|神秘的 湮灭
怎么|这回|淌满了 雨水 滴漏的$难看 痕迹
西部 助学|送 温暖$我献 赤诚|报党恩
健壮 剽悍的|西北 汉子$挺直|黄土 脊梁
沾血的 馒头$也|没能 挽回|病儿的 生命
羸弱的 躯体$已经 很难 支撑|这般 忘我
中方 愿与$科特迪瓦 朋友|携手 努力
他|代表 欧盟$谴责 这一|野蛮 行为
形成了|上下 贯通的$交通 保障 体系
市场上的|笨鸡$笨猪$笨羊|价格 高
尽管|杜秀云的 前额$被|头发 所挡
有|善纳 群言$闻过 则喜的|宽广 胸怀
重峦 叠嶂的 山脉$就|横亘 在眼前
山峦|枯黄的 身躯上$有|黑色|筋络 凸现
禅宗|诗歌 境界$所 探讨的|禅宗 诗歌
运用|飞碟|点燃|主 火炬$颇有 创意
除了|董艳梅 夺冠$还算 是个|好消息 外
火灾|塌房 等|事故 隐患$大量|存在
黑里|透红的 脸庞$带着|慈祥的 微笑
将|六胜塔 周围$浇注 水泥$巩固 塔基
宣讲 报告$在|离退休 老干部 中$反响热烈
古色 古香的|金字 招牌$熟悉|而 亲切
贵阳 超高压局|管辖的$千伏 贵阳|变电站
盛装|一吨 啤酒的|费用差$约为 十元
和$假烟|假酒 之类的|物质 造假|相比
我们 提出$追究 他们的|违约 责任
发挥 不错的|于根伟$杨璞|和 杜 威
参差|不齐的 边缘$同 墙壁|离开了 缝隙
我们|甩掉了 喧闹$和|闷热的 新德里
这就叫|光着 屁股 撵狼$胆大|不知道 害臊
不约 而同地$都朝 振梁|眨了眨 眼睛
鸟儿的 啁啾$和 几头 水牛的|哞哞 清唱
绝不是 什么|慢慢 腾腾$婆婆 妈妈
排除 干扰$刻苦 训练$严格 要求 自己
最终 点燃了|柯伊拉腊$辞职的 导火索
周围的 水$盐碱 含量 太高$污染 又重
委托 理财$虽较|实业 投资|赚钱轻松
九班长 周亮明$在|深圳 装货|耽误了 吃饭
给|粗犷的 溶洞$增添了 几分|纤柔 之美
他|耳闻 目睹了|外国 列强 入侵$军阀 混战
不怕冷$就怕热的|国宝 熊猫|秦秦
用 一双|长满|老茧的 手$常年|挖坑 栽树
风风 火火地$往|天文点|哨卡 赶去
时传祥|在|粪霸 手下$当了|十年 掏粪工
穿着 松糕鞋$在|疯狂 蹦迪|和 上网
床沿|横亘着 一条$极端|宽厚的 木板
一艘 外轮$满载|秘鲁 鱼粉|停靠 港口
黄继光$用 胸膛|堵 碉堡|枪眼的 壮举
邓小平|就|语重 心长地$告诫 全党
秦岭云$于志学$龙瑞诸 先生|交替 走笔
转经的 老阿妈$摇着 经筒|轻轻 走过
埃切维里亚 先生$此次|应邀 来访
专家 提醒|买瓜时$须|看瓜皮 瓜子|品瓜味
端详|理琪$那张|清秀|英俊的 照片
沃罗宁 表示$将|率团 出席|雅尔塔 峰会
到处 挖虫草$挖药材$挖发菜$乱淘金
妈妈 患|腰肌 劳损$和|椎间盘 突出
水库 淹没|郧县 郧西|良田 良地$三十 余万亩
肉体 残害$性 放纵$偷盗$甚至 谋杀
企图|以 所谓|九二 精神$取代|九二 共识
分|藏书馆$阅览厅$珍藏厅$三大 部分
我|宁愿 漂浮在$永恒 冷寂的 太空
全都是|中华 母亲 身上的$铮铮 硬骨
亲历了|海上 严打$紧张|刺激的 一天
蒸馒头 用的$面粉|柴火|是|怎么 来的
听到她|悲惨的 呼喊$我 真后悔呀
千娇 百媚|高石英$巧剜 明月|染 春水
如此 考究的 装修$和|雅致的 摆设
有|研究 探索$掌握 动态$捕捉|信息的 素质
凡遇|脚戴 金属环$或|彩塑环的 鸟
热情 豪爽|面子 义气$地位 勇敢|捧场 客气
不能|彻底 打掉$盘根 错节的|保护伞
街头的 垃圾桶$要|用药 喷洒|消毒 等等
那天 你|吞吞 吐吐$刚要 和我|说什么
淮南 煤田|潘谢 新区$煤层|埋藏 深
杨彩荣|咧开|没牙的 嘴$呵呵地 笑起来
想撂 挑子的|村支书$也来 精神了
滚地雷$锯齿雷$长波雷$雷声 轰鸣
用|扫帚 和|橡皮 圆簸箕$清除 垃圾
叮嘱|要把|损缺的 门窗 玻璃$补起来
什么|幸运呀$开心呀$超级 宝宝呀|之类的
他这个|莲藕 状元$自然|当不 成了
见 几名|中国 工人$拧螺钉时|不认真
堪培拉|四季|树茂 花繁$绿草 如茵
还把|金沟寨 特产的|茄梨$送给 冰心
一笔 一笔$掰着 手指头$跟我 算细账
除|流行 音乐$游戏 笑话$夫妻 悄悄话 等
浑与 庸俗$低级 下作$沆瀣 一气 焉
仿佛 借助|鬼斧 神工 雕凿的$一扇 天窗
爱钻 牛角尖$爱挑 毛病的|找 几个
乡下人|开口 就是|李大 耳朵$赵小 个子
他 要求|班子 成员$既抓 案子|又抓 脑子
处于 逆境时|毫不 气馁$勇往 直前
使|死者的 近亲属$遭受|精神 痛苦的
包涵$多么 深刻|和|丰富的 内容啊
墨写的 谎言$掩盖 不了|血写的 事实
诸韵颖$邱爱华$李艳$尹琳$暂不 参加 集训
陈果|慢慢 回想着$那|痛苦的 一 幕
检察院的 胳膊肘$真的 会|往外拐
当时的 博鳌$道路 狭窄|房屋 破旧
他会|给 老师$一盘|朗诵 课文的 磁带
当天 晚上$查到|海底 光缆的|阻断点
客人|可|自选 讲解 内容$并|多次 播放
这 河边的|砖头 土坷垃$还得 清理呢
会昌县|去年 共|炸毁$私盐 卤池 十口
但|丝毫 没有 动摇$万隆|改革的 信念
过 正月|耍 二月$吃吃 喝喝|又 三月
这|盐碱地上|春天 白茫茫$夏天 水汪汪
怕|伤了 花草$又 惹起|自责|和 悲 怜
免去了|采购 做饭 洗涮的$操劳 忙碌
陈佩斯 主演的$迷途 英雄|少爷的 磨难
别客气$我|很 乐意 帮忙$应该的 来回答
煎饼 果子|大麻花$塘沽 海鲜|狗不理 包子
来自|密歇根州的|亚伯拉罕$现年 五十岁
对 三七的|种子|茎叶|苗质 切片的 质量$作出了|明确的 规定
在|甘肃省 会宁县|河畔乡$可算个|顶刮刮的 好地方
家家 户户$仍然 靠着|侍弄 手头的|一亩 三分地 过活
一月份$对 三名|骨龄 超标的 球员$给予|禁赛 一年的 处罚
中国 足协$在 广东|对|参加 集训的|七名|十六岁 以下 球员$检测 骨龄
在|环南 中国海|自行车赛$第六站 比赛|夺冠后
确保|受灾 群众$度过 一个|欢乐 祥和的|双 节
要|按照 有关 规定$严格 掌握|救灾款的 使用 原则|和|使用 范围
以|警勤兵$消防员$卫生员$参谋 人员 为主的|防卫|训练 体系
使 仓库|由$原来 装运|十节 车皮|需要 五小时$缩短 为|三 小时
专家 教授|拥军 模范$经常 应邀|到 仓库|传经 送宝
警察 发射|催泪 瓦斯弹|和|橡皮 子弹$驱赶 示威者
俄罗斯 独立报$三日 刊登了|对|伊万诺夫的 专访
二是 由|享受|租金 补贴的 家庭$根据 实际 情况|自主|选租 住房
以|租金 补贴|为主的 模式$激活|廉租房 制度
一是 由于|廉租 住房的|专项 资金$不算 充足
由于|工作 单位|距离$和|居住 习惯|等的 差异
需要|更加|快捷|系统地 掌握$国内外|矿产 资源|动态 信息
一些 地区|受|山体 滑坡$泥石流|崩塌 等|地质 灾害的 威胁
矿业权 管理|信息 系统的|开发$与|推广 使用
刚刚|参加完 长跑的 经理$孟夏玲|兴奋地 说
一方面 使|古巴 政府$节省了 大量|用于|进口 蔬菜的 外汇
山东省|邹城市 公安 机关$依靠|群众的 支持
但|更 感谢|党|和 政府$让 他们|离开了 水窝子
被|淳朴的|蒙古族 风情$和|不断 进取的|民族 精神|深深 吸引
强调|反恐 斗争$应在|联合国 宪章的 宗旨|和|原则的 指导下
曾同|埃博拉|病毒 感染者|直接 接触过的$有 四人
新华社|波哥大|五月 二十一日电$记者 刘连祥$哥伦比亚|警方 宣布
从而|一举 摧毁了 这个$国际|贩毒 洗钱 集团
仅|可卡因的 年产量$就占|世界 总产量的|一半 左右
贵州段|采用|调查表$评价表$和|厂家 报价表|竞标 选择 供货商
仅用了 三分钟$就 炼出了|第一炉 钢$原来 炼 一炉钢|需要|四个 小时
李瑞环 等|领导 同志|走上 舞台$亲切地 接见了|主要 演职 人员
湖南省|省长 助理|阳宝华 等$出席了 今天的|开通 表彰 大会
一方面 使得其|基本的|理论 原则$实现了|东方 跨越
他们|精心 打造的|爱情 故事$既 诙谐|又 浪漫
该片|无论 是|故事的 设置$还是|演员的 演技
这部 电影|在|一九九八年$力挫|来势 迅猛的|泰坦尼克号
许多 作品中|塑造的$自尊 自强的|女性 形象
描写 人$就|不能 不是|描写|差别中的 人$等级中的 人
雷达的|秋实 凝香$是一篇|带有|歌颂 性质的 作品
近年来$以|满腔 深情|投入|散文 创作的|李存葆
其|每一篇 文章$都|容纳了 详尽的 史实$及|透彻的 解说
此篇的 主题$与|周同宾的|饥饿中的 事情$是 同样的
把 散文|这块 天地$拓展得|更为 宽广|和 自由
这样的 作品$确实 给|散文 园地$带来了|一片 生机
精短的|散文 写作$越来越 受到|报刊|和|读者的 欢迎
这是|该院|尊重 知识$尊重 人才的|一个 缩影
青藏 铁路|开工 纪念|小型张 邮票$今天 面世
应当由|外国 银行 总行$向|中国 人民 银行$提出|书面 申请
各|民主党派 中央$无党派人士$参加了 报告会
党政 机关$一律|不准 搞|相互 走访|拜年 活动
已从|该 基金|得到|首期 赔偿金的|纳粹 劳工 人数$将 超过 十万
完善|客运|分账 核算 办法$和|工效 挂钩 办法
他的|英雄 壮举$是|矗立在|我们 心中的 丰碑
经|省科技厅 组织的|专家组$现场|实割 验收
决心 尽|一切 努力$开好 下届|中非 合作 论坛
抒写|南中国 热土上|弄潮儿$勇立 潮头|唱 大风的|创业 气概
无论|整个 时代的 潮流$如何|波澜 壮阔|曲折 多变地 涌动
那两名 叫|柳本尊 和|赵智风的 僧人$看上这|叫|马蹄湾的 地方
柳本尊 赵智风$都|隐湮于|迷离的 烟霞|唐宋的|风采 之中了
彩色的 诱惑$向|暗色里|勾勒成 一幅|绝美的 轮廓
一点 一点地|消融 于|湛蓝的 天$翠绿的 山$和|雪白的 云中
方知|廊棚的 来历$还 连着 一段$动人的 传说
省|新闻 出版局$强化了 对|报纸|扩版 涨价的|审核 管理
湖北$河南$江苏$山东|部分 电厂|煤炭 库存 形势|较 紧张
用|贬值 这种|总量 政策$来|解决|结构性 问题
厚重的 世纪钟$布满|大小 齿轮 链条|与|硕大的|螺丝 铆钉
一些 职工|上班 时|把 企业 当作|酒馆|茶馆|澡堂子
第四号 台风|尤特$像|一只 猛兽 一样$袭击了 汕头
我 真怀疑$这|贫瘠的 黄土 高坡|竟是 她的|出生地
我|并不 知道$就在|大禹|劈山 治水的|禹门 古渡的 旁边
我 有幸$真的 站在了|错开河$清亮亮的 溪水里
湍急的 溪流|在|桥的 下面$组成 一个|声势|颇为 壮观的 瀑布
溪流|和 你的 视线|一并$消融 在|一片|蓊蓊 郁郁的|森林里
也|对不起|时或 一鸣$或 长鸣的 鸟语|与 蝉 声
飞鸟|大都 成了|玩鸟人$鸟笼里|局促的 囚徒
始终 未能|听懂 它|滔滔 不绝$地老 天荒的 语言
有如|交锦 错绣的|丝绒 织成的$豪阔|而|华贵的 地毯
横跨 大庆市的|近|百公里 长的$城市 主干道
也可以 观赏 到|游弋 在|荒滩上的$一簇簇|土色的 羊群
用户 向|全国 联网$服务 优良的|寻呼台 集中
电话|是|彻底 实现了|城乡 无差别的$少数 领域 之一
我国|煤炭 产量|连续 三年$每年 减少|一亿吨 左右
公安 分局|对|各 派出所$实行|双向 挂牌 督战
贯彻|干部 队伍|四化 方针$和|德才|兼备 原则
美军 目前|共|拘押着|二百名 塔利班$和|基地 组织 战俘
包括|财产 损失 保险$责任 保险$信用 保险 等|保险 业务
未|按期 交还$并且 在|当年 年底前|未 使用 完的
不得|仅因|细微的|非实质性 错讹$拒绝 接受|关税 配额 申请
在|篮板球 一项上$不但|没占到 便宜|反而 落后
在|南太杯$中国 围棋|名人战$五番棋 决战的|前 四盘
甲壳虫 乐队|最年轻的 成员$二十七岁的|乔治 哈里森|走了
他是|四月一日 上午$在|洛杉矶的 朋友家|病逝的
甲壳虫|由|利物浦的 四名|平民 男孩$组合 而成
世界 遗产|在 中国 图片展$三日|在|波黑 首都|萨拉热窝|拉开 序幕
继|竹溪县 龙王垭 有机茶$成功 打入 欧盟后
并 收回$不再 担任 代表的|人员的|执业 证书
三旅行社 破产$造成 旅游者|预交 旅行费 损失的
船舶 买卖 租赁$以及|其他 船舶|资产 管理
请相信|铿锵的 玫瑰$不是 那么|容易 凋零的
在|最后的|冲刺 阶段$谁 都无力|将|对手 甩开
委内瑞拉|平均 每分钟$就有|一辆 汽车 被盗
图书馆员 队伍的|整体 素质$与|现代化 图书馆的 要求|不适应
工作面 单产$比|推广|综放 工艺前|提高了 五倍
朱自强 等人|在|宁波 酒后 闹事$造成 极坏的|社会 影响
水产品 用|甲醛 浸泡|排放 污水 现象$得到|有效 控制
建成后|宁波港 万吨级|原油|中转 码头|仓储 容量$达|二万 平方米
他 指着|车厢里|挂着的 那台$并未 播放的|电视 说
河南省 洛宁县|西山乡 汤家沟村的|汤鸿君$做梦|也 没有 想到
公司|弥补 亏损|和 提取|公积金$法定 公益金后|所余的 利润
直接 关系到|党的 路线|方针 政策的$贯彻 落实
和平奖|从|一个 侧面$反映了|冷战 结束 以后
阿富汗 妇女$已开始|摘掉|蒙头 蔽面的 面纱
以|一小时|十分|三十一秒的 成绩$夺得|本站 赛事的 冠军
李兆林|就把 自己|一直|没 舍得穿的 一套|新 冬装$送给了 他
你认为|买通了 这个 部门|就能 拿到 项目$又错了
提出|调整 谈判 人员$并|断绝 同该|供应商的 关系
江泽民|听取了 何厚铧$关于 澳门|近期 情况的 介绍
二零零三年|飞来 峡区|成立 以后$才|划由|飞来 峡区 管理
残碎的 陶片$或许 是|先人|留给 今天的 残骸$或 暗语
香港 还|成功 抵制了$亚洲|金融 危机的 冲击
营造|整洁 绿色$美丽 现代$文明 友好$祥和 活泼 有序的|氛围
于|当地|文史 资料中$见到|毛泽东 手书|三垂冈
以此 提高 学生的|就业 竞争力|这个 招牌$来|吸引 学生 就读
金杯|银杯$如若|缺乏|人民群众的 好口碑|这一 基础
集体 改宗|脱离 印度教$成了 贱民|唯一的 出路|和 手段
向着|重振 大国 雄风的|既定 目标$不断 努力
酷爱 实地的 马晓春$虽然 将|黑棋|几子 吃住
对 张家界|一家|航运 公司$失去 经营权的 调查
但|日本 海上 保安厅|早就 清楚$该 船上|没有|捕鱼 用具
最高 人民法院$还将|陆续 出台|有关 婚姻法的|其他|司法 解释
建设$反过来 又|促进|更 广泛|更 普及的 应用
首次 将|模棱 两可的|买一 送一$定为|价格 欺诈 行为
全球|经济 增速 放慢$必然 导致$对|石油 需求的 减少
欧佩克 和|非 欧佩克 产油国$缺少 足够的 合作|与 默契
此谱|修纂 和|刊印 于$清 嘉庆 十一年|一八 零六年
世纪 国际|人居 标准 研讨会$二十三日|在|珠海 举行
在|连木沁镇|圈起|三十亩 戈壁滩$建立|农业 科技 推广|示范 农场
有|多个村 属|社会 矛盾 复杂村$管理 混乱$干群 关系 紧张
禁止 他|离开|拉马拉$前往 伯利恒|参加|圣诞节 庆祝 活动
北京市 法院$开展|知识 产权|审判 工作 以来
以|创新的 思路$培养|造就 一批$既善于 学习
要|大力 培养|和|大胆 起用$年轻的|优秀 人才
一大批|驰骋 市场的|民营 企业 品牌$脱颖 而出
绍兴|纺织业$不仅 夺回了|曾经 失去的|市场 份额
图为|第 十二届|律师 资格 考试$北京市|某考场 门前的 情景
并|经常 带领|陈家 唢呐 班子$走村 串户$为|村民们 演出
所刻 佛经$为|妙法 莲花经|普门品 第二十四
优质 规范|高效的 服务$是|招商|必不可少的 软环境
已有|四个 省级 检察院$三个|分州 市院$成立了|预防 机构
以|调侃的 音调$映衬了|金子|对 大星|懦弱的 无奈
这 正如|火候 不到|就 揭锅$瓜果 不熟|就 上市
如何 保障$农村 老人|这一|弱势 群体的$晚年 生活
要|进一步 拓宽$党政|领导 人才的|选拔 渠道
简单 肤浅 片面地|对待 中央的$路线 方针|和 政策
必然 丧失|坚忍 不拔$顽强 拼搏$奋发 向上的 精神|和 斗志
香港|特区 政府$就|觉察到|繁华 表面下的 隐忧
我|从来 就 没说过|中国的 市场$不该有|中国 特色
德国|证券 市场 中$银行 持股的|色彩 浓厚等
人们 在|银行 邮局$争相 购买|一袋袋的|欧元 硬币
穆罕默德 谢里夫汗$在|经过 警方 询问后$被|带回|巴高 专署
一是|完善 境外 投资|法规 体系$和|管理 体制
展示 其|出色的 跷功|椅子功$及|唱念 做打 等
又用|细腻 柔和的 表演|体现 金子的|善良|和 同情心
排水沟|只用|锄头 加宽 加深$而 不采用|其他 措施
并从|修缮|村小学 危房$和 改造|村集体的|一百亩 果场 入手
入世后|我国|煤炭 进口的 关税$将|逐步 降低
今年|全国|税务 系统$要|认真 贯彻|中央 提出的$完善|和 稳定 税制
慢性|肾功能 衰竭$是|各种 肾脏病|发展 到 后期的|综合 症状 群
这里面 融入的$其实 就是|妈妈|自己的 情感
亲情 乡情$一下子 把|查文红|回家的 念头|拉得 很近
而|这个 帷幕的|背后$将会 涌现|诸多|治水 英雄
西辽河 上游的|翁牛特旗$平地 松林|八百里
老哈河 流域$喀喇 沁旗|大牛群乡|通太沟村
能|投资 办企业|或 买房$如|京郊 区县的|售房 广告|就 写明
实在 不容易 完成|精准的|传切 配合$和|足以 构成|威胁的 射门
阿根廷 代总统|阿道弗罗德 里格斯萨阿$五日 上午|宣誓 就职
圆明园|正门 西侧|大部分 门脸房$被 拆除
为|全面 了解|和 考核|电压 质量$创造了 条件
冰城 哈尔滨市的|室外 温度$骤降到|零下|十摄氏度 以下
哈尔滨市的|临床 用血|有 相当 一部分$来自|个体 卖血
已成为|竞争 激烈的|传媒 市场的$一匹 黑马
三峡 工程 淹没|涉及|湖北 重庆的$三个 县市区
一些 江段|由|造纸厂 排放|造成的 泡沫带$也 消逝了
欧盟|都以|十分 活跃的 角色$出现在|各个 热点中
激起|国内|和 亚洲 邻国的|强烈 愤慨|和 抗议
傅怡彬|对|当初 练习|法轮功的 情形$仍然 记得 很清楚
倡导|团结 协作$淡泊 名利$乐于 奉献的 精神
用了 多年的|办公楼$舍不得|花点|小钱 装修
该场|为|博士后 科研 工作站$辟出了 办公楼
同时|还 查实了|乡领导$冒领|退耕 还林 款粮|等 问题
受|由|西西伯利亚 东移的$弱冷 空气的 影响
逐步 扩大 公民$按需|申领 护照的|试点 范围
图为|当雄县 牧民$正在用 牲畜|驮运|过冬的 饲草
北方 联盟 领导人|拉巴尼 宣布$把|政权|交给 卡尔扎伊
等|总结 材料 写完后$再商议 填个|理想 数字
正确的 程序|应该是|先把 数字 汇总好$核实 核准 之后
其|主导 产品$谷氨酸的|发酵 产酸率|国内 领先
二十七岁的|安妮 勃朗特$写出了|安琪 格雷
在|教堂|与 她们|住家 之间的$大块|空旷 地里
就像|中国 古代的 故事|嫦娥 奔月$夸父 追日
优质|专用 小麦$双低 油菜籽 比例|继续 扩大
肖永灵$将|两封 装有|虚假|炭疽 杆菌的 邮件
互联网的 希望$还基于 一种|青春|英雄的 躁动
另有 学者$则|提出了 与|减税 主张|不同的 观点
他 能使|队员的 长处$得到|最大 限度地 发挥
中国的|工程 科技$将 书写|更加|壮美的 篇章
大约有 六名|古巴人$被|恐怖 主义|夺去了 生命
全国 政协|副主席$中央 统战部 部长|王兆国
为|出入|兰州 航空港的 车辆$提供了|快速 通道
原以为|关公 战秦琼的 笑话$只是|相声 艺术的 夸张
他们是|任天野$许还幻$张晶晶$杨佩衡$紫琪 等
诺奖 得主|和 其他 贵宾们$先在|市政厅的|休息 大厅里 等候
以 哈尔滨|冰雪|大世界 为代表的$冰雕 雪塑
她们|将在 明天$与 韩国的|崔永真 崔荣一$争夺 决赛权
火灾 大约于|三日晚$二十时 十五分$由|宾馆 北楼|一楼 歌舞厅 烧起
当|凶手|奋力 挥刀|砍向$朝夕 相伴的 亲人时
是|汉武|派 张骞$走出 一条|丝绸之路的|艰辛|与 繁励
古装剧 戏说片$依然是|许多 导演的|抢拍点
以 她的 死$控诉了 充满|铜臭味$和|道德 沦丧的|黑暗 人间
化用了|民族 舞蹈 中的|双抛$对展$托举$飘围 等 动作
向|教导 孙子的|年轻 女教师$虔诚地|跪下 谢恩
终于 使 老人|三代 单传的 孙子$戒掉了 毒瘾
喇叭袖|中式袖|筒袖 等|款式的 运用$会 收到|很好的 效果
白雪公主|和|七个 小矮人$是|电影史上|票房 价值|最高的 影片
认为|护士 工作$是|稍加 培训|就能 胜任的|熟练 工种
病人|魏秀丽$在 写字板上|歪歪 扭扭地 写着
而|薛申 等人 缺阵$肯定会|削弱 国安队的|攻防 水准
实德队|夺取|足协杯 冠军$显然|更有 说服力
否则|哪怕 是在 首都$也有|误踏 地雷的 危险
适当 调整了$主产区|烟叶 价格|区域的 分布
不慎|失落了 一条$织有|黑白 纹饰的|驼色 围巾
发给|人手 一份$印有|驯鹿 图案的|精美 证书
弄得|病人 及其 家人$丈二 和尚|摸不着 头脑
当 学生 时|就知道了$文学|是 人学|这样的 命题
我是|见过 夏公衍$而且|听过 他|几次 谈话的
悟出了$软鸡蛋|也是 有它|赖以 保全的|生存 哲学
他们|深藏于|敖鲁 古雅$最|原始 茂密的 森林里
假设 此刻|便是|敖鲁 古雅$一个|平常的 夜晚
他们|以|粗犷 热情的 歌声$赞美 自己的|山水 森林
饮恨的 情绪|进一步 压倒了$本该|认真 进行的|总结 反思
也 推动了|新一轮$全球|多边 贸易|谈判的 开启
解放军 总医院|肝胆 外科 主任|周宁新 教授$在|腹腔镜 辅助 下
吉林|市委 书记|朱忠民$给|所属|县市 区委 书记|写信
梅加瓦蒂 总统 丈夫|陶菲克$率团|于|三月 一日|抵京 访问
有的|也 只是|面条$水饺$馄饨$油茶$和|油条 糍粑|等 早点
淮南人|吃 牛肉汤$很大 一部分|是|钟情于 辣椒油的
一位 老大妈$在 小庙旁|卖 香烟|葵花子|糖果 零食
从|很远的 地方|看见她 洁白的 牙齿$和 手腕上|亮闪闪的 银镯
黑黑的 眸子里|映着|多依河的 水色$和|小姑娘 手上的 花枝
其 结果|如|套改 一句$此时 无声|胜有声的 白诗
孝宗朝$因|台省|月月 有人 举荐$而|始得 复出
丹棱|枫落 水库|出现 险情等 问题的$四川 日报 记者|张显光
发扬|不惧 艰险$不怕 疲劳$连续 作战的 精神
国家的|法令 法规|在我 这里$也得|变通 执行
去年 一月|曾以|巴参 联会 主席$和|陆军 参谋长|身份 访华
步步高|无绳 电话杯|全国 女子|排球 联赛$第四轮|全面 展开
为 我国|文艺 事业的|健康 发展$提供|科学 基础|和|正确 引导
一九九七年$到|延安 马列主义学院$和|中央党校 学习
主导 产品|地塞米松$要|超越|世界 王牌|罗素 公司的 产品
他们 给|信访局|送来了 许多 锦旗$和|感谢信
就|手握 镢头$躺在|刘家垒的 地基上$不让 施工
对|受害人的|住院 医疗|鉴定 等费用$应予|酌情 赔偿
办一个 案件$要|责成|犯罪 嫌疑人|写一份 悔过书
她$磨蹭了|好长 一会儿
他|毫不 犹豫地$跟|犯罪 嫌疑人$从|二楼的|窗口 跳下
要|特别 做好|深挖|黑恶 势力 保护伞$和|黑后台的 工作
燃放|烟花 爆竹$对|人民 健康|有 百害$无 一利
木屋|高高的 尖顶上$画着|抽象化了的|圣诞 老人像
驻滇 某|工兵团$一年 一度的|野外 训练$在|滇中 某地 展开
把|隐藏 较深的|黑恶 势力|犯罪 团伙$挖出来
冯村镇 税务 干部|砸门 扭锁$拿走|农民 财物的 行为
克服|信访 工作|推诿 扯皮$久拖 不决的|老大难 问题
使|法制 宣传 教育|持之 以恒$坚持 不懈地|抓下去
国际 棋坛的 震惊$和|国人的|欣喜 若狂|势必|理所 当然
三台|大于 十吨的|燃煤 锅炉$在 年内|改烧 洁净煤
一艘 停泊在|南京港$名为|提提斯的|塞浦路斯 货轮
目前|川陕甘 三省$共 建立了|四个|大熊猫 保护区
其中 黑颈鹤$丹顶鹤$白头鹤$白枕鹤$灰鹤$蓑羽鹤 六种|是|繁殖鸟
促进了 一些$濒危 物种|种群的 恢复|和 发展
这个|淮河 之滨$洪泽 湖畔|美丽的|苏北 小城
展览中的 那些|热烈的 场面$和|感人的 细节
轨道 运行$是|防止|以权 谋私的|根本 举措
给|寒冬 时节的|京城 棋坛$增添了|热烈 气氛
认不认可$看作|衡量 工作 好坏的|唯一 标准
纺织品 服装$是 我国|数一 数二的|出口 行业
一百米|红外 望远镜$为|我国 天文学家$开辟了 新的|观测 窗口
努力 提高|以|市场 来 配置|探矿权$采矿权的 比重
以|避免 因|反导 条约 失效$而|出现|法律 真空
转变 为|科学 轮收|季节性 休牧$以及|舍饲|半舍饲的 饲养
已 完成$警戒|押解|抓捕|处决 等|各类 任务$三百 三十二起
以|新的 训练 法规|为 标志的$正规化 管理 体系
万人 千车|巧借 天时$隐入 寒彻的|白山 黑水间
他的 妻子|头部$有一刀|从|左侧的 面颊|横过 口裂
他|不避讳 记者的 询问$和|公安人员的 审问
连年|超额 完成|上级 下达的$外汇 结算 任务
我们 都有$粉碎|任何 台独|分裂 图谋的|坚定 决心$和|充分 准备
对方 所要 砂轮的|品种$规格$数量$一目 了然
因|镇川 之宝|都江堰$巧夺 天工|润泽 不绝|而|水旱 从人
一支穿|橄榄绿的 队伍$奉命 走进了|中华 商业|第一街
早早 来到|他们|称之为 母亲街的|南京 路上
延安的 思想$延安的 精神$延安的 情操$延安的 作为
艺坛|出现 一批|仅止于 寻求|生理 快感的$非审美类 文化
由|政府 划拨$改为|拍卖 租赁 等|市场化 运作 方式
包括|思维的 敏捷性$灵活性$深刻性$独创性$和 批判性
活脱脱 是|天神 地母|拣尽了 人间|自然 坦荡的 情愫$铺就 而成
面对|碧沉沉的 大海$和|横无 际涯的|红海滩
朝鲜队的|陈别喜$利用|中国队 门将 赵燕|扑救 脱手
获得|优先权的 棋手$可 挑选 自己|为 黑方|或 白方
每天 晚上|都要|一小杯 茅台酒 暖身后$才能|睡得着 觉
同根 同祖 同族$而又|一海 相连的|闽台 同胞
以|优异的 成绩$迎接|党的 十六大|胜利 召开
再没 才能的$拖上 几十集|也|混了个 脸儿熟
父亲|告诉 程丛夫$一个|英国 车队|看中了 他
开惯了 卡丁车的 他$还不是 很习惯|换档|和 离合器的 控制
他恐怕 语言的 障碍$会|漏掉 教练 教的|哪怕 是|一丁点 细节
这|一整套 体制$全都是|靠|日本 企业 吃饭的
五万 平方米$拥有 病床|三百 张的|新门诊 住院 大楼$投入 使用
土家人|严格 恪守$斧斤 以时|入 山林的 古训
大金塔内|珍藏有 佛祖|释迦牟尼的$佛发 二十根
而|顾客 在|不知 不觉中|上当 受骗$花 冤枉钱
从小|学 木匠 手艺的$西藏 拉萨 农民|洛桑达瓦$忙完了 农活
许立群的 两只眼$看 体育|和 李中文的 简单的
程斯煌|咬紧 牙关$卖掉|家中|所有的 稻谷|和 一头 肥猪
见|所有的|政府 机构$端端 正正地|挂着|这样的 广告
就是|撒满$峰峰 岭岭|沟沟 壑壑的$金色 阳光了
只见|一架|巨大 无比的 竖琴$架在|不远的 山梁上
年终 岁末|回过头来$看看 想想|所 走过的 路
缅怀|张学良$杨虎城|两位 将军的|历史 功绩
涉及|民族|宗教 因素的 问题$得到|妥善 处理
诺贝尔奖|从|一九零四年|首次 颁发$至今|已走过 百年
但|三九 严寒|照样 弯着腰$在|冰冷的 水中|洗衣 汰菜
老朱|七妹的 儿子$是个|打羽毛球的 好苗子
已|退居 二线的 廷桂$仍像|当|教导员时 一样$关心|新来的 同志
目前|尚不 清楚|死伤者$是|以色列 定居者|还是 军人
漫长的 边界$已 成为|两国 人民|进行|友好 交往的 纽带
五假|分别 为|假 凭证$假 账$假 表$假 审计$和 假 评估
要|指导 帮助|和 支持|宗教 团体$结合|各宗教的 特点
肉贩们|一边 麻利地|从|箩筐 里|捡出$猪头 小肠 等
西安事变 发生 当天$东北军 出版的|东望 杂志|第六卷|第六 期
但|存单 所记载|金额 中的$部分 款项|已 支取
一九九九年 实施|路地 共创$鹰厦 平安|铁道线 举措 后
常昊的 白棋$便在|盘面 左边|形成 一道|厚势
中俄|更有 必要$加强|各 领域的|磋商|与 合作
冷峻的 现实$挑落了 一幅|蒙满 灰尘的|现代 神话
曾经 是|文学 期刊|经营者$很少|谈论的 话题
县里 领导|不出面$便 显得|不够 礼貌|不重视
浙江|绍兴 晚报|刊登|贪心 判官$刘福彪 一文
如|有的 物品 表现$颜色 褪色|开裂|和 粉化 等
普通 微波炉$是 利用|磁控管 发射的|微波 加热$来 烹调 食物
我们|深深 感到$邓小平 同志的 胸怀$像|宇宙 般 宽广
联合国 秘书长|安南$三日 在|挪威 首都|奥斯陆 说
果蝇脑内的 蘑菇体$在 抉择 过程中|发挥了|重要 作用
法官|依此法|放走 两名$走私|海洛因的 嫌疑犯 后
土地 补偿费$是 农民|失去 土地 后的|养命钱
下岗 职工|基本 生活|保障费 补助$以及|地方 财政|减收 补助 等
明年|俄 联邦|航天 预算额$将达|八十四亿 卢布
苏珊 贝里斯福特 女士$作为|福特 基金会的 总裁
对|禁伐区|森林 资源的 管护$做到|五 落实
羽绒服的 填充料$由 传统的|厚 实 多$被 现代的|薄 轻 纯|代替
如今的 宁波$是|春 有花$夏 有荫$秋 有果$冬 有绿
在 这里|能|生动 体现其|善良的 本性$和|多彩的 民风
一场|突降的 大雪$使 北京|经受了 一次 考验
几乎|每条 道路上$都 挤满了|慢慢 往前挪的 车
预防 消灭|或者|控制|蚊蝇 蜚蠊鼠$和 其他|有害 生物的
所有的|广场 中央$几乎都 耸立着|大型 雕塑
他是|真正 懂得|诗词 格律$并 追求|诗律细的 诗人
胡愈之 先生|郁达夫 先生$都得到过|他的 帮助
有些 学者|有|生造 词汇$搬弄|新概念的 习惯
艾哈迈德 沙赫的 儿子|帖木尔$将 首都|迁往|喀布尔
先后 丢失|喀布尔|马扎里 沙里夫$和|昆都士|等 重镇
较为 详细地|勾画了$科技 资源|配置 体系的|框架|和 模式
进行|鱼虾 混养|虾蟹 混养$和|淡水 对虾 养殖|新技术 试验
到处 是|变形的|钢梁 瓦楞板$以及 家具|和|办公 设备 碎片
塔利班|和|纳吉 布拉达$成交出|坎大哈的 协议时
减轻|对 企业|催收 货款的 促进$和|推动 力度
所|编发的 文章$常常 是|大腕 明星|拥有|多少 财富
使用的|香水 口红 丝袜$是|哪个|西方 国家 进口的
回避|过于|厚重 臃肿|飘逸感 强$女性化的|服装
面料 以|纯毛|羊绒|开丝米|真丝$重磅 麻纱|金丝绒|纯棉 等 为好
劳累了 一周的|凤凰城$疲倦地 躺在|沙漠中
丁零零 一阵|清脆的 闹铃声$把 陈挺|从|梦中 惊醒
他们 因为|献血 输血$或|配偶 母婴 传播$不幸 感染 艾滋病
倪志福|仍不忘 抽空|和 他的 同行$研究 倪钻的|改进 创新
哈特金斯 夫妇的 儿子$现任 总裁|布莱恩 归纳为
笔者 几年前$在|某军区 总医院|五官科 实习时
记账的 女士|接过 我的 门诊卡$和|治疗 交费 单
另外 遭淘汰的|三位|九段 棋手是$汪见虹|廖桂永|和 吴肇毅
而应|积极 争当|善于 团结 别人$协调 各方的 模范
对外 友协 会长|陈昊苏|到会 祝贺$并|发表 讲话
号称|全球|第一 畅销书的$谁动了 我的 奶酪
有人|就|靠在 船帮上|眯着 眼$倾听这 近乎|天籁 之 声
也不忘 给自己|和 祖宗$修一座|豪华的 阴宅
也可以|叫这些 小姐$给 奶奶|和 老娘|做 保姆
震中 位于|阿雷 基帕省$萨拉曼卡县的|一个 山村
看到|饭桌上|被 同学们|扔掉的$有|白花花的 米饭
几乎 所有的|餐厅 饭馆$都没有 张贴|节约 粮食的 标语
给 唐山|留下了 一个|特殊的$伤残 孤寡 群体
课间 休息的 孩子$正在|坟旁 玩|猫捉老鼠的 游戏
对|有财产 担保的 债权$和|无财产 担保的 债权|分别 登记
鄂黄 大桥|不仅 把|几百万|黄冈老区 人民的 梦想$变成了 现实
岭南山区 小饭店 掌柜|驼哥$在 国共|和|日伪的|拉锯战 中
从|编 导 演|哪个 方面$都 看不出|优秀的 痕迹
在|相当 充实的|戏剧 情境 中$赋予 精神|遨游的 空灵
执导 此剧的|张仁里$准确|精到地 把握了|戏的 品格
这种|价高 冷淡$再 提价|更 冷淡的|恶性 循环
那种|为了|自己的 腰包鼓$而 去掏|幼少 口袋的 做法
以|宋大城|双瓮城 遗址|为 依托的$宋代 文化|展示 中心
供不 应求$导致|卤虫卵 价格|一度 攀升到|每吨 一万元
我|多么 留恋 那份|少年报啊$作为 一个|作曲者
丁关根|罗干|姜春云|曹志|肖扬|韩杼滨$出席了|今天的 座谈会
章钟|逼平|八号 种子$保加利亚 棋星|托帕罗夫
为了 使|宣传日的 活动$既|轰轰 烈烈$又|扎扎 实实
立即 采取|诸如|通告 修理 退换$或|退赔的|处理 措施
林海音|已 出版|小说 散文$儿童 文学 等|共六部
喜爱|瑞典|乒坛 名将|老瓦的$中国|乒乓 球迷
金泽洙|吴尚垠$击败|中国 香港的|张钰|梁柱恩
住宅 要|完全 采用$无毒 无害的|建筑 材料|来 建造
以|超过 每股|净资产|数倍的 价钱$参股 平安
被 侵权人|需要 支付$搜集|侵权|证据的 费用
刘半农|郑振铎 等 呼吁$开辟|俗文学 研究 阵地
着重|对|世称|黄山 三绝 之一的 云海$进行|观察 悟化
与|时下 影视界 出现的|戏说风$豪华风$滥情风 有别
没有 脱离 故事的|旁逸 斜出$和|拖沓的 剧情
实行了|夜间 清扫 保洁|夜间 运货$和 渣土|夜间 运输
我愿|惊天 动地的 虎啸$不仅|长存|铁 栅栏里
我们 在|没有 灯的|木头 走廊上$说了 一会儿 话
通过|搜索 引擎$直接 提供 给了|相应的 商家
有效地 控制了|艾滋病$在|军队的|蔓延 态势
还有人 举着|一把 一把$用 麻绳|扎好的 桂花
我们|乘坐的 客车$在|苦桃溪 附近的|山弯处|停住了
梳着 刘海|扎着 小辫的$光溜 白净的|瓜子脸上
她一双|很黑的 眼睛$在|昏黄的 光亮里|快活地 闪动着
似乎|从中 寻到 一点|温暖 欢乐$而又 骄傲|得意的 感觉
也都 渴望|矮小的 身躯$能有|更大 更高|蓬蓬 勃勃的 生长
那里 包裹着|斗转 星移|大地 裂变时 迸发出的$火焰般的 激情
栽植了|两万 多亩|冬桃|冬枣 等$多个 品种的 冬果
雇佣|陈四群 组织 人员$在|阳坡 元村|白草涧 采伐 树木
国家|重点 工程|铜川 矿务局$王石凹 煤矿$走|科技 兴矿 之路
张远山的|吊驴子文$和|周泽雄的|耳朵的 立场
但|为了 报答|海外 琼籍 乡亲$对|琼剧的|热爱 之情
吹开了|爸爸 妈妈|紧锁的 眉头$和 我们|苦闷 不安的 心田
大使 先生|最近 又给|非国大$捐赠了 计算机
我们 没有|一枪 一弹$还|侈谈 什么|武装 斗争
让我 这个|只骑过 牛的 牛郎$不免|有些 自卑
有些|发卡 单位$在 广告中|屡屡 使用|模糊 语言
执白的|罗洗河 八段|开局 走得$便|不甚 简明
欧元的 流通$将 免除|各种 货币|兑换的 麻烦
声音的 后面$跳动着 一颗$多么 健康的 灵魂
他 目睹了|惨绝 人寰的$武汉|和 重庆 大轰炸
谈了|国人|随地 吐痰|等 陋习的|成因的 看法
仅用|三年 时间$就|培育出 六个|三倍体|枸杞 无性系
无论 是在|试管苗|生产 实验室$还是在 试管苗|移栽 温室
又|先后 捣毁了$盗窃|石蜡 木材|耕牛 松子的|团伙 十个
谭晓林|国际|贩毒 集团|在逃 成员$丧心 病狂
将|反馈 意见|及时 回复|居委会$和|居民 本人
硬是 在|乱石堆 中$开出了 十亩|能种 果树的|梯田 来
看过|颇具 规模的|经济林$成片的|塑料 大棚$宏伟的 引水 工程
专家 认为$高性能 耐火 耐候钢|填补了|国内 空白
李心草|邵恩|林克昌$分别 执棒|三场 音乐会
用 手术钳|把|蝶窦 顶壁的|骨折 骨片$慢慢 复位
不能|违法 重叠 和|交叉 设置$探矿权 采矿权
然后 将|体细胞的 遗传 物质$植入|卵 空壳内
对|为什么 要|解放 思想|更新 观念的 道理$似乎|都 清楚了
储蓄卡|和 存折$这两种|有价 单证|同样 有效
在|塔河 河畔|种了 十年 棉花的|夏龙清$已经|累计 开地
但 老板们|宁愿 花|几千 块钱$请|登门 说客 吃饭
大连 实德队$在 重庆|以 三比三的 比分$逼平了|重庆 力帆队
肥东县 八斗镇$位于|江淮|分水岭的 脊背上
投资|八亿元 改造 而成的|光明街 顺安路$宽敞 明亮
随着|江苏 姑娘|金娜 和|侯颖纾$挂上|花样 游泳|双人赛的 金牌
一些|河滩 湖泊的 名称$也 带有|绿色的 意象
如 珍珠滩$盆景 滩$流翠滩$孔雀 河道$翠海$芳草海 等
去|黑汉岭|黑松林|鹰翅梁|狐皮沟$或|冷泉 三滴水|之类 地界
颠得|坐它 后臀上的|卫家 小媳妇$屁股蛋 生疼
惹得|隔壁 名字 也叫|二妞的 姑娘$听了|好不 高兴
具有|短信 手写$短信 群 发$短信 预制$短信 连收 等 功能
中国 女子 垒球|将在 很多 位置上$留下|难以 弥补的 空缺
杜韦诺|何君龙$邓汉升|蒋伟洪|这|四名 运动员$跑出了 十一秒的 成绩
伊马纳利耶夫$感谢 胡锦涛 副主席$拨冗 会见
秋季 型人 搭配$应 遵守|同色系|浓淡 搭配的 原则
耶德瓦布内$是 波兰|东北部的|一个 小镇$以下|简称 耶镇
并|游览了 科技园$和|虎门 炮台 遗址|等 景点
你 将会|清楚 看见$与你 同样|对 生命|热情 执著的 脸
北京市|向 外商 投资 企业$发放|问卷 调查表|一百 余份
以|艰苦 卓绝的|开发 劳动$和|忠贞 不渝的|献身 精神
据|新华社 洛美|五月 十日 电$记者 蔡施浩$科托努 消息
整顿|和 规范|税收 秩序的 核心$是|堵塞 漏洞
免 百日 之忧的|生活 准则$使 他们|忍气 吞声
排湾族的|男女 竹竿舞$节奏 明快|热烈 奔放
楚州 区委|区政府$为了 揭开|燃料 公司|亏损的 盖子
在 我们|成天 嘀咕着$为|冷门 项目|打抱 不平的 同时
中国 企业|完全 应该|坦坦 荡荡地$放开 手脚
万亩 大姜|桑蚕|西瓜|圆葱|芋头|果品 等农产品$在|国内外 畅销
突然 调侃 到|帝王 印章的 小气$炫耀$造作$狂妄|和 狡诈
听取了 该校$关于|培养 专才|和 通才的 做法
偶尔|碰见 几个|剪枝的 园丁$和|闲聊的 老人
科索沃 阿族|和|塞族的 政党$作出了|不同的 反应
负责 食堂的 民警$是 通过|公开 竞聘 当选的
李小鹏|一口气$连得 跳马|和|双杠的 金牌等
在|大剧院的 售票厅$永远 都 买不到|当晚的 门票
脑磁图 技术$是|欧美 探测|核潜艇 技术$在|医疗上的 移植
它们|沉醉 于|血腥$色情$尸体 和|暴虐的 快感 之中
一口气|连夺 男子|撑杆 跳高$男子|一百 一十米栏$男子 跳高|三块 金牌
越南 海防市|社会 恶习|抵抗局的 官员$已前来|商谈过 几次
恩施州 州长|郭大孝$明确 向|政府|有关 部门 提出
参与 指挥了|湘西 剿匪$抗美 援朝中的|空战 等战斗
四川 选手|方敏$和|广东 选手 李蓉娟|分别 以
不合格者$将 按合同|从 承包费中|扣除|相应 费用
无奈$配套 软件的|匮乏 使其|仍在 市场中|艰难 跋涉
路边的 大树|也 耷拉下了|翠嫩的 叶子$这次 大旱
九运会|女子 单人|双桨 比赛$一百米的|争夺 之后
他们|无法 说清$多少次|冻僵的 双腿|难以 站立
哪怕 连一颗|螺丝钉的 位置$也要|反复 验证
颇有 一种|争奇 斗妍$你方 唱罢|我 登场的 喧嚣
抑或 这些|劳苦 大众$都 身处|寸草 不生的|爱情 沙漠
只见|一直 陪着 我们的|彼德$慌慌 张张地 朝|停车的 地方 跑去
汽车的|挡风 玻璃 上$马上 会留下|一张 罚单
鸭绒 有味$鹅绒的 蓬松度|超过 鸭绒 等 说法
征收|反 倾销税的 税率$不得 超过|倾销 幅度
相对 匮乏的|教育 资源$面临着|严峻的 考验
这些 意见|启发|滨州市委 一班人$深入 思考
家父|是 向人 称述|自己 父亲时$所用的|谦词
霸王 别姬$笑傲 江湖$大宅门的 音乐$均|可圈 可点
鲁迅|在 谈到|鉴赏 红楼梦时$就曾|列举 读者的|种种 眼光
才 发现$在|自动 扶梯的|下角|透明 玻璃钢处
商场的 电梯$肯定 有 提示|站稳|扶好的 标示
场地边|破天荒地 出现了 多架$照相机的 炮筒子
改造 过去|挖泥 烧砖|遗留的 废窑坑$发展|立体 水产 养殖
脚踝 有伤的 杜峰$在|开场 不久|也|披挂 上阵
她的 刺绣|体现出 苏绣$精细 雅洁的|独特 艺术 风格
写成|工人 小偷 小摸$郊区 农民|哄抢|工厂 财物的 事
土壤 肥料|管理 体系$和|监测 体系$初步 建立
立法的 目的$是|为了 保护 环境|和|食品 饮水的 安全
驻村的 省|国土 资源厅$姚加平|解庆昌 两同志$帮他|寻医 问药
曾经|沙临 城下的|策勒人$向 沙漠|反攻了 五公里
泪水|从 那双|饱经 风沙的 眼睛中$滴落 下来
纵贯|塔克拉玛干的|沙漠 公路$是一个 奇迹
自恃 有|沈克诚|撑腰的 老吴$嘻嘻 哈哈地 笑道
一把 扯过 那张$盖有|沈克诚 印章的 处罚单
冰雹|霜冻|干旱|雪灾等 灾害 次数$有增 无减
已经|不只是 听听|各路 专家$纵横 捭阖的 评说了
碑帖 兼融$努力 摒弃|生硬 拼凑|而 追求|内涵的 变化
张云川|胡彪|文选德|周伯华|孙载夫$当选为|省委 副书记
书人|怎能 没有|迷离 若失$恍惚 不定的 感觉
六十五 公斤 以上级|内蒙古 庆格勒$对|湖北的 张敬奎
上百幅 精美的|释迦牟尼佛 说法图$和 韦驮|护法图
可以|帮你 找到$属于 自己|皮肤 属性的 季型
春季型的 人$拥有 一双|活泼 明亮的|浅褐色 眼睛
鉴于|目前 这种|促排卵 药物$随处 可以 买到
摇身 一变$竟成了|名牌 大学的|硕士|或 博士
无遮 无拦的|黄土 高坡$更 显出|大西北|夏日的 炽烈
又有|中国 杂技团|软钢丝$那|叹为 观止的 神韵
但你|总得 让人家 感到$被你 采访|是 值得的吧
对|各类|肾小球 疾病$有着 良好的|治疗 效果
那么|假货|还在 折腾的|根本 症结$在 哪儿呢
达赖 喇嘛$作为|藏传 佛教|格鲁派的 首领 之一
颁奖 揭晓会$将于 明年|一月 中旬|在京 举行
大伙 立马|七手 八脚$把|带泥的 红薯|从|火灰里 扒出来
我|忽然 听到 几声|巴掌 打脸$或|脊梁的 声音
必须|善于|正确 处理$改革 发展|稳定的 关系
学生 就寝后$学校 就将|疏散 楼梯|全部 锁住
都没有|事故 应急 照明灯$和|疏散 指示 标志
就|敢于|破除 那些$不适应 形势|和 任务 要求的$老 观念$老 框框
贾老|把 我国|考古|低 水平的 展览$形容 为|摆 地摊式
他们|采写出 许多|生动 活泼$内容 扎实的|新闻 调查
恐怕 只有|象牙 之塔 里的 贵族$才有|观赏的 本钱了
还是|较为 抽象的$吹过 雷峰塔的 风$扇舞 丹青|篆刻 印象
以及|横穿|乐美乐 峡谷的 速降$和|攀越 绳网的|越野 技能
要在|一百尺 高的|低桩 铁丝网下$匍匐 钻爬 十公里
组委会 共评出|金狮奖 一个$银狮奖 两个$铜狮奖 三个
城管 工商 交警$谁见着 卖菜的$都要|没收 东西|砸秤 罚款
堆放着|一筐筐|卖不 出去$已经 烂掉了的 西红柿$茄子 豆角等
儿子 是你|最孤独的 镜子$和|镜子里的 谎言
其中|充满|动人 心弦的 感受$和|可歌 可泣的 场面
镇党委 书记|卢勇$一连 几天|到 该村|跑 田坎
她在|治理过的 沙地里$种上了 庄稼|果树|西瓜|和 哈密瓜
她让 儿子|拿出|满满 一大 提包$奖状|和 证书
这使得 拦门砂|是否 可以 开采$变得|扑朔 迷离
但是$随着 我对|当地|缺医 少药|状况的 了解
自个儿$却 眯着 他那双|再也 长不大的 小眼睛
邻居 一位|下岗|再就业的 女工$疼爱的 目光
天生 长了 一副|娃娃脸的|赵蕊蕊$非常 有人缘
想方 设法$把 故事 讲得|曲折 生动$充满 悬念
他 赶紧|挥挥手$赶走 脑门上|那 摩拳 擦掌的|绿头 家伙
远处 有几丘|花花 绿绿的|金属 或|塑料的 房屋$点缀 其间
同行的 朋友|小陈|咔嚓 咔嚓地$按了|好几次 快门
典雅 壮观的|议会 大厦|坐北 朝南$矗立在 这个|小山丘上
其中$血管 内皮 细胞$在 烧伤|早期 脏器|损害 发病中的 作用
梁山 好汉们$大碗 喝酒|大盘 吃肉$即是 明证
因为|父亲 当年$常 给我 讲|八仙 之一的|韩湘子
但我 仍|深深 眷恋|昨日 那$古朴|醇厚的 老街
是 窝窝头|和 地瓜$伴她 度过了|求学的 坎坷
其|哀鸣式的|垂死 挣扎$又一次|以|失败 告终
其他 报刊|可以 转载$或者 作为|文摘 资料|刊登
这些 农民$只好|挑着 担子|开着 车子$远途 奔波
子洲县|驼耳巷乡$流传着 乡长|贺占武|六顾 茅庐
刘振华$刘泽民$张宝顺$侯伍杰$金银焕$当选 为|副书记
有他 回忆|黄佐临$萧友梅$贺绿汀$沈湘$徐迟$卡拉扬的 文章
吃水|就医|洗澡|交通|取暖 等$也存在|不少 困难
法案 加重了$对|泄露|防卫 秘密 行为的|惩罚 措施
兑|欧元的 疲软$和|兑 日元的|相对 稳定$将 可能|继续 显现
每周 至少$供应 配发 出租|六个 品种的|新片件
佛道 两家 共存的|繁荣 局面$将会|魅力 再现
他在|隋朝 做官时$是一个 以|阿谀|奉承 著称的 佞臣
倾诉着|人间 常见的|离愁 别恨$和|重逢 之喜
明朝 皇帝|赐与 他的|都督 印$令牌|和 斩刀等|三件 赐品的|复制件
那|华丽的 红木|茶桌 茶凳$透着 一股|高贵的 气息
陈顺源|与 儿子|陈文雄|及 女儿$在 茶苑|查看 茶叶
他们|荐股 涨跌的 准确率$并不比|大猩猩|随便 抽取 股票|更高
多情的 土地$成了|袒胸 露乳|裸肚脐的$真皮 亮相
小贩们|兜售的|鲸脸谱 风筝$批发价|只有 三元
我们|天天 忙着$参观|上海 农垦的|下属 企业
真正 做到了$看 明白 病$住 明白 院$出 明白 钱
且不说|那|野旷 开阔$坻平 水软的|沙滩 风情
很多 难民|参与$亲 塔利班|组织 举行的|募捐 筹款
水中的 芦苇$是否 还|萧萧地|唱着 缠绵的 歌
遇到 有|公物 损坏$就|自己 掏钱|修理|或 更新
蔑视着|他们 所谓$男不男 女不女的|冷嘲 热讽
有的|还 打着|投资 办厂$搞活 企业$增加 税收的 幌子
将为 此后|波兰的|入盟 谈判$制造|更多的|困难
新疆|巴音郭勒|蒙古 自治州$且末县|且末镇 县城
面对|高昂的 打官司的|诉讼费$律师费|一筹 莫展
这就是|汪洋湖的 爱人$温淑琴|给人的 印象
遭到|王明 左倾|机会 主义 分子的$残酷 打击
这个村|现在 已经 建起$蘑菇 种植 大棚|五十 多个
潇湘 电影 制片厂的|毛泽东$在获|最佳 故事片 奖
以 弥补|木材|限额 砍伐后$产生的|财政 亏空
促进|各民族的|共同 繁荣$和|中华民族的|全面 振兴
远远 满足不了|偌大 农村$七亿多 农户的 需要
我们 愿与$包括|秘鲁 在内的|各 经济体 一起
关于|粮食|合同 定购$与|供应|化肥 柴油 挂钩|实施 办法
它 宛如 一条|绸带$柔媚地 缠绕在|广场 南边
丰收了的|贫困 农户$称它是|脱贫 致富的 金钥匙
当 穿着|破旧 衣服的|小马楠$怯生生地|喊出 妈妈 时
我在|宾馆 大厅$捉到 一只|类似|蝈蝈的 昆虫
被抢的 行人$遭 二人|轮番 用 木棍|猛击 致死
他们俩$别别 扭扭的 样子
竹峰乡 中学 老师|汪世宏$从|去年|三月份 开始
并把 自己的|切身 感受$用|民情 日记的 形式|记录 下来
怎奈|地理 恶险|经济 穷窘$和 种种|难理 难断的 纠葛
百姓 不知道|踏勘者们$从|犀牛江 方向|返回 兰州的 途中
读过|美国 作家$托马斯 沃尔夫的|一篇 小说
恩纳济|和 纳伊米$因为|累积 两张|黄牌 停赛
卡塔尔队 主帅|坎波斯$对 球队|进行了 调整
做到|一级 带一级$一级 抓一级|层层 抓落实
躲在 车内的|另一名 歹徒|周继化$手持 炸药|窜出
北京 首都|剧场的 舞台上$舞姿 婆娑|乐曲 悠扬
仅仅 靠|舍本 逐末的 新政$或|补苴 罅漏的 变法
又|相继 批准 新建了$规模 为|年产 三十吨 左右的$金属镁 企业|七家
就|更应 警惕 那些|心怀 叵测$妄图|分裂 祖国的|势力 和 个人
一枚|精巧的 书签$像一只|素雅的 蝴蝶|翩飞 而至
每一次|都是 母亲|把|包谷面 馍馍$蒸好 放凉
减少 沙漠|对$耕地 和 人类|居住 环境的 破坏
难免 因|不了解 情况$而|错把 荣誉|给了|不该给的 人
将|繁难|偏旧的 内容$作了|较大 幅度的 削减
为什么|单单 买卖|假文凭 一项$撇开|买假 用假者
卢沟桥|因 其|横跨 卢沟河$今 永定河|而 得名
公仆的 称谓$与|父母官的 称谓$是 有着|天壤 之别的
感到|不把 这个 卖国的$专制的$极端 腐败的|清政府 推翻
宣读了|全球|华侨 华人$反独|促统 大会 宣言
包括|巴东$栎白$杜女贞$枇杷$朴树$青檩$紫薇 等|七个 品种
他们 所承诺的|将来|增值 回购$是|不现实的
米卢的 神奇$正和 足球的|不可 捉摸性 吻合吧
一面 绣有|中华魂|三个 大字的 旗帜$在|看台上 传递
对于|亲身 经历过|比赛的 球员$和|教练们 来说
俄罗斯|航天兵 司令|佩尔米诺夫$近日 表示
三名 前锋|谢晖|宿茂臻|和|张玉宁$改打 后卫
他需要|在 这种|不断的|批判$辩解$坚持$惊慌$和 逃窜的|过程中
交替 进行|变速跑$练 蛙跳$走 鸭子步$蹲 杠铃$跳绳 训练
没有|相当的 艺术 胆识$是|不敢|有此 奢望的
摸索 出了|十平方米|麦草 方格$沙障 固沙的|最佳 方案
一个|戴着 黄帽子$手持|竹扫帚的|高个子 环卫工
负责 施工的|中铁 隧道局$出色地|完成 任务
但|汤先生 却又|毫无|数典 忘祖的$顾盼 自雄
这位|饱经 沧桑的 老人$满脸|都|溢满了 幸福
只有|昼夜 值勤的 警察$或许能 令人 感到|一点|紧张的 气氛
提足 嗓门的|谈笑|和 咳嗽$在 其间|快乐地 起伏着
别号|借山翁$杏子坞 老民$三百 石印 富翁 等
发现|同样 睡不着觉的|车手$也在|苦苦 溜达
一系列 满族|特色的 旅游节$把|辽宁人的 胃口$吊得 更高
秋风 拂动|桦叶的 金光$欧洲杨的 火红$五针松的 墨绿
贴切|自然地 表达了$辽阔 深沉的|草原 气息
西方 观众|竟能为 昆剧|琵琶行$感动得 落泪
修建了|滨江 广场$妙观寺 广场$体育 广场 等|三个 广场
彻底 扭转|文物 市场$秩序 混乱|假货 赝品|泛滥的 局面
一位|四岁的 女孩$因患|先天性 弥漫性|肝内 胆管|束性 扩张症
如|冯巩|郭冬临|陆鸣的|三人 相声$台上 台下
松山 探险营$将 前往|延庆|松山 自然 保护区
市社保局$不仅 不同意|永安厂的|购买 要求
中央 储备粮|管理 领域$看|堆|守摊|观念 盛行
单县 公安局|城关 派出所的|民警们$捐款 七百元
但|此后的 消息$却给|印度 经济|泼了盆 冷水
以|确保 粮食|购得进$管得好$调得出$用得上
我 认为|鲁迅|光靠 一堆 杂文$几个 短篇|是 立不住的
对付 嗡嗡叫|最好的 办法|是 不理$惟沉默|是 最大的 蔑视
那种|使猛人 昧于 世情$脱离 民众的|包围者
公然|挂牌 办公$公然|招聘 大学生$公然|出动|执法 车
天宇|奋飞的 大雕$沙海 勇行的 骆驼$蓦然|闯入 眼帘
并 举行了|盛装|行进 表演$及|彩车|巡游 活动
也多是|长期 积累|萦绕 于怀$偶尔 得之的|某种|特殊 状态
我 很敬佩$顾维钧 先生的|外交 才华|和 为人
舀一勺|碎芝麻|和 红砂糖|搀和成的 馅$放在 里面
对于 我们 这个|习惯 含蓄$讲究 分寸的|民族 来说
卡维地络$是一种|非 选择性的|受体 阻滞剂
正在 收摊的|小店村|菜农 刘中信$给 记者|比划着 说
对于|巩固 温饱|成果的 难度$也要有|足够的 估计
拥有|先敌 发现$先敌 开火$和|先敌 摧毁 优势
恰给|吹漾于 河面的 清风$添入|袅袅的 谐音
一间 一间 学校$好像|雨后 春笋般$在|山野 村寨 出现
是|败坏|党的 事业$和|党的 形象的|两大 祸害
河北 献县|淮镇 北街$吞吃 统筹 提留款的|馋嘴 村长$已被 免职
致使|包装厂|停止 生产$无力 偿还|王某的 债务
马向芳的 哥哥|马向俊$到了|应征 入伍的 年龄
星星 点点的 河灯$形成了 一道|蜿蜒的 火蛇
张牙 舞爪地$对 怀中的|札达 盆地|作势 欲扑
否则|无法 供养|奢华的 王宫$和|繁多的 庙宇
她 或 他|如何 急切地$在|擦擦 堆中|翻检着 搜寻着
有的|还 不断地 和|听众 席上的 熟人|打招呼
以军 坦克|和 装甲车$也|侵入了 部分|巴控区
一串串的 红灯笼$点缀着 草地上|临时|搭起的 舞台
对|成千 上万的|无辜 蒙难的 人员|及其 亲属$表示|深切的 哀悼
格罗哈莱妙|布伦特兰 夫人$以下 简称|布夫人
直到 近日$昏倒在|宣讲|七一 讲话的|讲台上
黑的|白的|棕的|各色 马匹$蒙着|只露|正前方的 眼罩
我|真切地 面对了|生命的 死亡$和 美的 死亡
南非|此次 前来 参会的$是|该国|夸祖 鲁纳 塔尔省
为 这洼|苦咸水$起了 一个|温馨 浪漫的 名字
这|并 不是说$要 我们|跟在|群众 后面|当 尾巴
在|长达 三个月的$集中 查处 信访的|十起 积案 中
医生|看着 她|气喘 吁吁$疼痛 难忍的 样子|不解 地问
学生|可以用 鼠标|拖动 导线$来|切割 磁力线
在 澳大利亚|凯恩斯城$宣告 组成|这个 集团
随着|两万张|走私 盗版 光盘$日前在|广东 珠海|顷刻间|灰飞 烟灭
不过|米卢 此仗的|排兵 布阵$还是|令人 吃惊
紫光檀 千佛$以 法源寺|大雄 宝殿中|毗卢 遮那佛 为范本
一时间|咬牙 切齿的 咒骂$充斥了|众多 功友的 言论
手扶着|那 九百个|偏环 扣联的$晃悠悠的 铁链
瓦蓝的 穹宇$像|刚从 水里|捞出来 一样 明净
他 满身的|叛逆 精神|和 英雄 气概|仿佛也|所剩 无几
这类 电视剧|大肆 渲染|铺陈 一些$穷奢 极欲的 情节
明尧 勒 古 战场 位于 喀什市 西北的|木什乡
放 警犬|咬|外国 黑人的|两名|白人 警察$出庭 受审
正值|新疆 吐鲁番|葡萄沟的 葡萄$收获 季节
并|首次 访问了$设在|布鲁塞尔的|欧盟 总部
轰炸了$穆萨纳省 境内的|民用|和 服务 设施
浩淼的|灵透的|故乡的 水$只能 从|记忆中 找寻
只见 两条|横跨 马路的|大红 标语$十分 醒目
以|澳门 青年|秦高 和$葡萄牙 少女|玛丽亚的|爱情 故事|为 主线
包括|邓颖超班|春蕾班 在内的 女童们$告别了|贫困的 困扰
曹洪昌的|孺子牛 金球奖$是他 手里 提了|两桶 汗水
华康的 收购价$连|化肥 农药的|本钱|都 不够
哥|军方 发言人|加夫列尔$康特雷拉斯 透露
兼并了$地处 息烽的|某部 直属|宏泰 化工 总厂
在人们 对|库艇|沉没 原因$议论 纷纷的 同时
一位|患脑瘤 夭折的$哈萨克族 女孩的 父亲
乌克兰 选手$塔玛拉|耶罗|费耶娃$是|全场|无可 争议的 亮点
会任|情感的 奔马$驰骋在|思想的 天穹
突然 一个|愣头 小伙$赶着 驴车|斜冲了 过来
坐在 右首的|阮培金 代表$接访的 群众 最多
诸如|某某 领导$扶贫 示范 基地$某某 领导|民心 工程等等
到过|第一 军医 大学$南方 医院|惠侨楼的 人
一公里 狭窄|沙石 山路$大约 需 行车|两个半 小时
北约的 行动$根本 伤不了 阿族|非法 武装的 筋骨
其 情形|与 宣言|所 重点 分析的|西欧的 情形$就|大为 不同
他信 总理|两次$亲自 主持|大规模|销毁 毒品
你们|何享健 总裁的 车$总该是|公家 配的吧
省委 组织部|副部长|张金康$一边 目送|匆匆 离去的 考生
高技术 基地$又该 充当|怎样的 角色$交出|怎样的 答卷
他 怒斥|江青|陈伯达|康生 等$妄图|篡党 夺权
他的 头颈上$竟趴着 一条|光溜溜 亮晶晶的 怪虫
谱写了 一曲|血|与 火的 礼赞$情|与 泪的 颂歌
日本 自卫队|扫雷艇$赴 海湾 地区|进行|扫雷 作业
接受|出版 单位的 委托$印刷$报纸 期刊的|增版 增刊
芦荟|冬瓜|半边莲$减脂 养胃 保肝|应有 尽有
楼大鹏|邓亚萍 等$绕场 进行|跑步 火炬 接力
而|保守党 前领袖|黑格$则|公开 表态|支持|邓肯 史密斯
广大|仍过着|贫困 生活的|印度 百姓$对此|深恶 痛绝
有的 连|看都 不看 一眼$就把|合同书|甩得 老远
捆绑|吊打 不干$搜查|抄家 不干$贪污|受贿 不干
那是 一座|绿荫 匝地$灰瓦 白墙$古色 古香的 院落
无论 怎样|哗众 取宠$不过 弄一顶|小丑的 帽子|戴一戴
尽管 日本|歪曲 历史的|教科书$采用率 很低
表演了|俾格米 妇女|采摘 野果$捕蛇 抓兔等|生活 情景
为|忙忙 碌碌的|现代人$提供|雅俗 共赏|老少 咸宜的 娱乐
正|满怀 豪情地$准备|奏响|雄壮的 军乐$迎接|四海 宾朋
用 氧焊枪$切割着|足足 高出|一米多的$高帮 车厢
色彩的 滥用$使 本来|很 雅致的 建筑$变得 恶 俗
她 身上|至今|还留有 四处$被 日军|戳伤的 刀口
它 可以有|科普 卡通片$卡通 样式的|广告片
俄罗斯的 萨多娃$以|八十米 获得|女子 铁饼 金牌
但 她|最终|还是 被|丈夫的|敬业 精神$所折服
那么|北爱 目前的|困窘 局面$就会 有所 改变
商品 交换|这个 概念$包括 一些|什么 内容呢
另一 方面|从 汪慎之|汤定之|陈少鹿$学|花鸟 山水
从 十多岁|到|六十多岁的 网民$都 踊跃 参与|讨论 交流
但 如今|已 落入|低谷的 队伍$一争 高低的 挑战
许广平 先生|慷慨地$将 鲁迅的|大部分 手稿|捐给 北图
因此|提醒 大家$一方面|赶快 下载$并|安装 微软的|补丁 程序
以|假冒 伪劣 电缆$代替 合格的|矿用 阻燃 电缆$向|他人 供货
尽管|刚锄过的 庄稼地$遍布着|败草的 尸体
但那|绿的 川道|绿的 山坡|绿的 沟岔$是|很 诱人的
脚下 逡巡着$目光 搜索着$手中 淘选着$嘴里 商榷着 价格
女子|一万米的 冠亚军$被|埃塞俄比亚的|图鲁|和 瓦米 摘走
大量|伪劣 絮棉 制造者$因|无法 找到|而|逍遥 法外
他们 使用|十九 世纪|九十 年代 初期$患|瘙痒症的|十只 绵羊的|脑组织 样本
猪 到麦田$拱 食糟|踏 麦苗的 情况$时有 发生
两位 镇干部$正与 雷伦福|在|池塘边 讨论着
西边的 窗户|已被 一块 木板$严严 实实地 挡住
葫芦居里|唯一 亮堂的 场所$莫过于|东窗 台下
在 角落里|教你 如何|兜售$卑劣 奸诈|和 诡计
借着 月光|和 星斗$仔细 品味着|身旁的 一切
瑞安 警方|在 云南$将 准备|外逃的 主犯|叶崇楷 抓获
而|一捆捆 杏树|扎成的 苗木$则 透出了|殷殷的 红意
听听 那|撒泼 打浑$自虐 虐人的|说唱 段子|和 相声
和|阴霾 密布的|邪教 惨案$形成|鲜明 对比的
范匡夫 最早$是|说给|分区 干休所|领导 听的
市 烟草 专卖局$在 金州|端掉 一个|藏匿|非法 卷烟 窝点
年幼的 苏轼$在|父亲 讲述|赣南的|山水 风光|习俗 人情时
河边 放牛的 乡亲$就把|他们的 衣服|抱过 河
漂漂站的 干警们$自发地 捐出|各自的|衣服 鞋子|和 零花钱
把|人文 奥运的|北京 申奥 理念$发挥得|酣畅 淋漓
奶奶|姑奶奶|和 姑姑$也和 他们|生活在 一起
让人 恶心的 假鼻涕$装神 弄鬼的 碟仙$成人化的|裸体 造型
第一个 转变$是从 长远的|全局的 利益 出发
菲利普 格雷厄姆$成了|华盛顿 邮报的 主宰
我 看到|满大街 跑的|尼桑$丰田$宝马$奔驰等|名牌 汽车
最近 拜读了|赵远帆的$百炼钢|化为 绕指柔 一书
跨进 我国|国有 企业 老字号$哈轴 集团|公司的 大轴门
堂而 皇之地$出台了 五项|支持|骗退税的 政策
图为|松鼠猴 妈妈$背着 猴宝宝$在|两只 雄猴的|护卫下 嬉戏
宋魁祥|以|雅翻 公司 为招牌$网罗了|大批 成员
软弱地 与|袁世凯 妥协$拱手|把 政权 让给|革命的 敌人
使|瞿秋白的 全人|和 魂魄$活在了|后人 心间了
那双 腾起|巨大 水花的|四十六码 大脚$则|泄漏了 他|超乎|众人的 秘密
渤海湾|和|琼州 海峡$客滚船|运输 市场|专项 整顿
今天 下午|前往 拉萨市$堆龙 德庆县|乃琼镇|乃琼村
琵琶亭|与 浔阳楼$已不再 是|纯客体的 存在
去年 二月 中旬$突然 咳嗽 痰多$胸闷 气短$频发 早搏
癫痫灶|定位 精确$是|癫痫 外科 治疗的|关键
他|先后 为|孔繁森 小学|捐资 捐物$达 万余元
昌都的 热巴$拉萨的 锅谐$林芝的|贡布 箭歌
酿造 酱油$是指 以|大豆 或|脱脂 大豆|小麦 或|麸皮 为 原料
或用|装满土的 袋子$和|庄稼 秸秆|填充 这些 裂缝
暂扣 或者|吊销 许可证$暂扣 或者|吊销 执照的|行政 处罚 决定
他 还将 访问|白俄罗斯$摩尔多瓦$乌克兰|和|马耳他 四国
涂过 该涂料的|粮仓 屋顶$比 没涂过的$温度 低|二十 摄氏度
静静地 躺着|用旧的|五线 琴谱$毛边的|英语 词典
而是 游荡到|土星 附近$被|土星 引力|所 俘获
但|正当 铁通 盘算着$二百元的 初装费$会 吸引|多少 用户
气氛|似乎也 随之$逐渐 变得 缓和|与 轻松 起来
因为 他|不能 忘记 十年前|蒙特卡洛$惨遭|滑铁卢的 一役
浓墨 重彩地 描抹了|彭德怀$屡次 受命于|危难 之中
已经 冲到|欢呼的|人群中的|出租车 司机$扭头 喊道
年少的|刚 呀呀 学语$负责 收藏 整理|赠品的|郭金忠|介绍 说
站在 被|朵朵 绽放的 礼花$围绕的 主席台上
而要|了解|传统的 斐济人$还得 去|斐济 民俗村
齐齐哈尔市|翁海 渡槽|泄水 闸门$缓缓 提起
在 监禁地|文托腾捏岛$起草了|文托腾捏 宣言
在|此起 彼伏的$网上 药品|招标 采购 浪潮中
每当 这|拄着 拐杖的|查灾 队伍$走进 村子时
就 被|他 和|战友们$用 娴熟的|擒敌 本领|一招 制服
五米高的 火头$从 宽约|二十 多公里的|边境线$平推|直逼 入境
结束了 国家$一盘 散沙|四分 五裂|任人 宰割的$悲惨 命运
持卡族|往往|无奈地|拥有 一大把$花花 绿绿的 卡片
在|塔里木 东海$四川 鄂尔多斯|和|松辽 等地
许银川 走出|弃车 杀炮$再|马跳 卧槽的 妙着
一时 说|口袋里 装有|红布条的$是|红军 探子
而|比利时 小将 海宁$在|另一场 半决赛 中$击败|卡普里亚蒂
表现 那一代人$扎根 边疆|建设 边疆的|执着 信仰
这些|小小的 变动$无疑 可以|突出 女性|挺胸 撅臀的|曲线美
当地的|司机 大佬们$都 称他为|平乐唐 师傅
诗歌 有|邓小平 之歌$铁锤 与 镰刀的|交响 等
望着|即将 出齐的|四卷$江苏 人民|革命 斗争|群英谱
瓦努阿图|共和国 总理$瓦努阿库党 主席|纳塔佩
从|上一次的|苍山 如海$到|这一次的|好爹 好娘的|先后 入选
南方 谈话的|思想 精髓$可以 概括为|如下 几点
不仅 将|当地的|大小 旅馆$挤了个|满满 当当
一锅|红红的 炭火$驱散了|闽西 山区的 严寒
张太雷$叶挺$叶剑英$聂荣臻 等|领导了|广州 起义
老人用 香槟酒|和|撒切尔 夫人$碰响了 国威
江姐$抛头颅 洒热血的|宁死 不屈 精神$和|人格 魅力
在|峥嵘 岁月$沂蒙 儿女|拥军 支前|抛洒 热血
针对|长期 困扰|中国 学生$哑巴 日语的 情况
私屠 滥宰$使|病害肉|注水肉|绕过 检疫 检验
马国英|襄樊 两桥|捆绑式 收费$该休矣
奋不 顾身|跳 列车的|全国 优秀|共产党员$邹宪光
英寸|比 网纹的|影写版 图文$印得 很细腻
望着|满身 水痘的 孩子$和|疲倦 不堪的 妻子
其它的|不管|三七 二十一$统统 宣告|破产了
李昌镐 九段$胜|代表 北美的|迈克雷蒙 九段
一方面|巧妙 避开了$从|正面 描写|施琅|对台 战争
特邀 钢琴家 李云迪$小提琴家|孔朝晖 演奏
通过 蔡文姬|与 左贤王的|情感 碰撞$与|悲欢 离合
钱其琛$黄菊$王刚$唐家璇$陈铁迪$徐匡迪$王力平等
记者 从|小河子 闸处$沿 滦河 干渠|溯流 而上 查看
正当 昨天|美国|中央 情报局 局长$特尼特|收拾 行装
经|台北 松山的|岛内 机场$台北 桃园 机场$香港 机场
这一排 房子的 后院$连着|后面 一排|小楼房的 后院
是|任何 敌人|和 困难$都 压不倒|摧不垮的 党
访问 不仅为|瓦杰帕伊 总理|今年 六月 访俄$铺平了 道路
他们|毅然 决然地$选择了|马克思 列宁 主义
建设 音乐 喷泉$和 人工湖 等|看水|听水|赏水的 景观
多名 信徒|排队 喝下了$掺有|氰化物的 饮料
听着|四川 电信 总经理|裴爱华$一点点 道来
波兰|必须 先答应|自掏 腰包$拿出|一亿 美元的 资金
调整 稳定|扭亏 摘帽$是|近期 实达|最|急迫的 问题
五吨 推力|轴承 实验台$和|八吨 推力 轴承|塑料瓦|性能 实验台
陶行知|又 掏出|第三块 糖果$塞进 王友 手里
淅淅 沥沥的 春雨$像 漫天的 飞花|撒落 下来
记者 乘坐|海军 航空兵|西沙 航班 飞机$飞抵 美丽的|西沙 群岛
贬低|甚至|讥讽 鲁迅$郭沫若$茅盾 等|革命 文学 巨匠
那|争分 夺秒的 姿态$使|旁观的 我|有一种|喘不过气的 感觉
居民 目睹 哪吒|脚踏 风火轮$告别 孩童 而去
真 善 忍|三个字$总是|在我 脑海里|晃来 晃去
是 世界上|一切 学说中$最 玄奥|超常的 科学
全县 呈现出|河断流$塘干涸$苗干死$树干黄$地干裂的 惨相
他们 所标榜的|真 善 忍$是|地地 道道的|假 恶 狠
裹着 冰甲的|十三匹 骡马$在|万仞 悬崖边|缓缓 挪动
子弹 从|朱广英 和|战士们的 耳边$嗖嗖 飞过
推进|潘渡$小沧$丹阳$蓼沿$长龙等 乡镇的 发展
汽车的 响声$把 难民们 从|凸库中|吸引 出来
向|登陆|首创 网络 信息岛|答题 获奖者$颁发了 奖品
又以|价廉 物美$保温 防漏$干净|无菌的 优点
也是|拉丁 文化$与|盎格鲁 撒克逊 文化的|分界线
为了将|质次的 沤黄米$加工成|雪白的 米粉
钻进|剖开的 牛肚$经 缝合 后|让人|挥刀 破肚
依诺沙星$诺氟沙星$环丙沙星$氧氟沙星 近年来
患 白血病的|江苏省 姜堰市|电信局 职工$杨宏志
全指望|宋廷权 妻子$在|几亩地里|打点 粮食
他们 怎么也 不相信$这位 以前|摘除过 右肾
墙的 顶端$是 一道|三米 多宽|向外 倾斜的 钢网
高杆上的 探照灯$把|边界 两侧|照得 如同 白昼
老实 巴交的 南进喜$可是|从未 招惹过 南喜元
根据 在|陪葬坑里 出土的$吕大 官印的 印章
胃癌|肝癌|肺癌|食管癌$是 死因中|最主要的 四种|恶性 肿瘤
开篇的 送葬|以人 祭狗$到|终篇的|打狗 吃肉
他 拿出|省吃 俭用|积攒的 钱$买了个 寻呼机
苏童的 驯子记$和 陆涛的|我爱 我爸$则 表现了|父子 情深
甚至|不尽 情理的 管教$包含着|融融的 温情
其中 主要是|一百 二十二 毫米|坦克炮 炮弹$和|高射炮 炮弹
满山 盛开的 迎春花$和|绿油油的|草丛 树木
多家|顶风 反弹|偷排 偷放 企业$被|强制 关停
骗取 批准$或者|勾结 串通|行政 审批|工作 人员|取得 批准的
企盼了|一天的 幼狼$这时 才能|分得些 猎物
深圳 某|电器厂|起诉 曾某$拒还|二十多万元 欠款
紧紧地 搂着|内装 借来的$五千元 现金的 黑皮包
不是 凌驾 于|企业 之上$念|紧箍咒的|恶 婆婆
但对|夺得 奖牌的 前景$仍 感到|非常有 信心
热衷于|拉关系 找门子$拉拉 扯扯|跑官 要官
更 舍不得|道班里$和我 一起|吃过 苦的 弟兄
沉痛 悼念|王恩茂 同志的 横幅下$悬挂着|王恩茂 同志的 遗像
一切|霸权 主义的|蛮横 势力$最终|都 难逃|捣乱 失败
刘长瑜|将携 弟子|耿巧云$管波$吕慧敏|演出 桃花村
说明 我们|有些 地方的 脱贫$脱得|并不 那么 牢靠
译林 出版社|先期 推出$人猿 泰山的|前 八本
人们 还发明了|具有$透视 功能的|隐形 眼镜
吃了|疯牛的 肉|或 内脏|而 得 脑病的$全世界|不到 一千人
常被|随处 可见的|狗屎 狗尿$熏得|兴味 索然
一些 养殖户|笑眯眯地 看着|海蛏 和 蛤$吮足 肥水|与日 俱增
一缕缕|香甜的 酒丝$飘入 街空中|针线般的 雨丝
新锐 女导演|田沁鑫$一贯以|泼辣 凌厉 见长
说成 是从|欧美 列强 统治下$解放 亚洲的 战争
村民 在$殡葬|嫁妆|红白 喜事|封建 节日上|铺张 浪费
探测 火星的|近地 表层$应成为|火星 找水的|突破口
榜上 有名者$则会|遭到 罚站|揪 耳朵|等 处罚
适当 加快|农业$富余 劳动力的|转移的 步伐
有的 领导 干部的|配偶$打着 领导的 招牌$四处 插手
王进东的 弟弟|何海华的$哥哥|姐姐|妹妹 等|一行人
悔意 萌生的|何海华$又开始 饱受|精神 折磨
恐怕 你 要找|方方 面面的 代表$来|开个会
伴随着 全球性|知识 革命 浪潮的$拍打 而来
大致 确定|三星堆 遗址群的|埋藏点$和|埋藏 范围
纠正|超标准 收费$和|农网 改造|搭车 收费的 现象
不知道 多年前|汤姆 汉克斯$牵着|梅格瑞恩的 手
在 雅典 奥运会上$冲击|赛艇 帆板|三枚 金牌
这个|棒棒糖$可真 好吃
以防止 目前|正在 欧洲 蔓延的|口蹄疫$传入 韩国
吃螃蟹|得了 甲肝了$等等|令人 吃惊的 新闻
眼下的 情况|犹如|三条腿的 板凳$断了 两条
其中 写有$我 一百斤 银粉硝|舍身 炸光 烧光
安徽|凤阳县 小岗村$成为|大包干的 发祥地
医生|将 一根|较粗的 导管$插入|切尼的 心脏
狭隘的 追求$使|拉美 劳务|市场的 竞争|愈加 激烈
但却|浸润着 主创者$眷恋 乡土的 一片|炽热 情怀
洗涤灵$洁厕粉$洗洁精$洗衣粉$漂白粉 等等
与|今天 面色 红润|活泼 开朗的 她$判若 两人
却总 忘不了$给 母亲|捎回 一小块$她 老人家|爱吃的 油糕
数以 千计的 死猪$堆放在 用|钢轨 架起的|木柴 堆上
在 好端端的 平原上$胡乱地|掏了 好多 豁子
为|救你的 美名$掩藏着|虐杀 你的|邪恶 目的
钻了|正规 厂家$忽视 低收入者|购买力 状况的 空子
开胃 菜汤|鱼|或 肉$蔬菜 沙拉|或 奶酪$甜食|或 水果$咖啡 或 茶
他们 把一间|宽敞|而 又有 天窗的|旧羊圈$打扫 干净
整顿 思想$整顿 纪律$整顿 作风的$三反 三整 活动
经常 碰到|被骗了 钱财$又|耽误 治疗的 患者
希望 在|纪伯伦的 棺木边$感觉出|他的 幻像
就 不会 允许 他|顺顺 当当地$把|幸福 日子|过下去
如 演唱|三娘 教子$空印盒$贾金莲 拐马 等等
粮缸 一空$就|挑上 箩筐|到|队里 粮库|去 挑谷
我 估摸|当年的 锅巴粥$是|柴灶 烧成的 缘故
绝没有|往 球场|乱掷 杂物|乱起哄的$粗鲁 行为
血吸虫 藏身|低洼 地里$杂草 芦苇的|钉螺中
还有|兼得 杨露禅|和 陈青萍 之传的|永年人$武禹襄
不同 人种 之间$头发|肤色|眼睛|鼻子 等的 不同
干着|推销 营生的|义诊 大夫$也是 不陌生的
轨道的 支撑物$是 形如|高压 电线塔的 支柱
而 小说中|占|相当 篇幅的|法庭 辩论$更是|高潮 迭起
若 没有|梅迪契|这位 伯乐的|赏识 栽培$和 提供的|优良 环境
明知|练功 违法的|刘春玲$还 吓唬|小思影 说
一些 邮票 公司$为 完成 任务 指标$而|大批量 抛售
细细 盘点|刚刚 耗巨资|击退的$百年 大洪水
打赢了|一场又 一场$漂亮的|扫黑 除恶 歼灭战
中国|敦促 菲律宾$切实 尊重|中国 领土 主权
他们 采用|放养 鲢鳙鱼$直接 控制 微囊藻 水华的 生物 操纵法
她 又|盘算起|法律 拥军$科技 拥军$文化 拥军的 事来
还有 跟随$达赖 集团的|少数|分裂 主义 分子
突见|满天 满地|皆是|灿烂 阳光$劈头 盖脑|不由 分说|砸下来
未婚 女性|爱穿的|旁遮比 套服$严密 包裹 人体
这跟|欧美 女性|袒胸 露肩|一览 无余的 着装$大异 其趣
糖师傅 手中|两把|锋利的 刀刃$闪着 清冷的 寒光
谴责|法轮功 邪教 组织$残害 生命的|残忍 行径
没有 监督$而|单纯 依靠|干部的|自律 和 觉悟
为了使|千千 万万的 旅客$过上|祥和 欢乐的 春节
春天的 雪|是 无声的$温馨 滋润着|油菜 花开
从|孔府家|孔府宴|秦池酒$到 前不久的|盖中盖
一排排|粗大的 钢坯模$散发出|灼人的 热浪
当 记者|背着 摄影包$兴冲冲|走出 候机室时
如有 大方者 肯用|膘肥 体壮的 牛$换 城里|阔太太的 波斯猫
挺拔的 孤挺花$夺目的 郁金香$雅致的 蝴蝶兰$纤巧的 秋海棠
要|不断地 排除$左的|或 右的|错误 倾向的 干扰
昔日|苍苍 茫茫的 白雪$正在 变成|财源 滚滚的 白金
处于 谷底的 奥神$却|得来了 一场|久违的 胜利
陪同 李鹏 出访的$李鹏 委员长的 夫人|朱琳
就能|痛痛 快快地$立刻 摘掉|赖账国的 帽子
内容有|养猪的|种菜的|食用菌 栽培的$王彦军|翻着 这些 书籍
反 魁独的 联邦派$以|一比零的 票数$战胜了|魁独 分裂派
高低 参差的|蕨类 苔藓|地衣 菌类$和 各种|鸟兽 昆虫
同时 允许|从|税额中$扣除|上一道|已经 缴纳的 税款
评估团 在|弹着点$或|弹着点 附近$都确认|辐射 有|微量的 增加
陕北 民间 剪纸$有|贴在 窗户上的|窗花 烟格花
所以 后人疑$青乌 先生的 葬经|乃|郭璞 所著
特别是 海螯虾|大虾|和 龙虾 等|高档 海鲜$严重 告急
他的 妻子|努尔斯曼$因 难产|痛得 死去 活来
观景台 另一端$有一尊 正|弯腰 搬石的|筑坝 工人 塑像
武汉|东湖 风景区的|三堆 篝火$彻夜 熊熊 燃烧
以|彻底 解决|球员$虚假 年龄 问题
他们 唯恐|三个月的 期限$过了 以后
切实 了解|彼此的 需求$和|市场 潜力
经 测量 发现$模型 对角线|偏差 一毫米
从$今天 刊载的|这组 稿子 看
棉花 产量|糖料 产量$增长|一成 以上
也感受 到了|激情 之水$奔突 摧涌下
端掉了 一批$制假|售假 窝点
那应该 是个$烟岚 缥缈的 早晨
乃|毗卢 化身$柳赵 二尊|开建 古道场
雪花|如 细碎的 盐般$从 天空|柔柔地 撒落
敢情|冰峪 度假区$一如|水泊 梁山
陡地 显见出 一片$璀璨的 灯火
就|拿来 一卷 竹帘$连在 屋檐上
桥旁|居住 一位$姓朱的 竹匠
楠竹|撑起 一竿竿$翠绿的 碧玉
沤在$嘈杂的 闹市中的|人 来说
如同|天上的 星星$与|星星 之间
中间 隔着|寥廓的 天空$和|辽阔的 荒原
两者 都有|诗样的 别致$诗样的 遐想
各省 举行了$专门的 选拔赛
使我 对|晨耕的 思念$滚滚|不能 遏止
好的 口碑$要比|金杯 银杯|难拿 得多
取代了 以前的$脏 乱 差 旧村
是|工作组 进行$帮扶|和 整改的 重点
美联储|不断 抡起$减息的 板斧
其 形状$酷似 一尊|坐姿的 佛像
今生 重温|冤孽情的$帮腔 烘托中
剧作家 喜欢用$叠字|叠语的 句子
在 苏州城内$乱跑 乱停|乱拉客
在这 女孩|红扑扑的 脸上$亲了 一下
每天 要说的 话$比|教师 说的 还要多
沙蒿 沙柳|麻黄草$随风 摇曳
冒着|数九 寒冬$凛冽的 北风
群众 有委屈$有牢骚$有意见
雾霭 层层的 日子$比|前些年 少了
先生|随手 拿了 一方|图章$给我 看
一踏上 这块|寒浸浸的$三姐妹 故乡
只为|比尔 盖茨的 暴富$而|拼命 追网
这一|劝告 隐含的$另一层 意思 是
夯实了|能源 交通$等|重要 基础 设施
为了 救助|得了 肾病的 妹妹$陆雪婷
那 倒在|汪汪 血泊中的$惨死者
它的 辣$和|中国 四川的 麻辣|不同
自然 型人$由于|腰 与 髋部|尺寸 相差 较大
烧伤科 护士|王淑君$告诉 记者
变幻着|绝无 二致的$斑斓 画面
他便 发出|高亢的$嗷嗷的 命令
帕沃蒂克宁$有力地|拍拍 我的 肩头
我们 跨进$生着|很旺 篝火的 帐篷
里面 在|汪着 水的 草地上$铺着 兽皮
财产的|差额 部分$予以 追缴
早插的 秧苗$已经|挺直 腰杆
刚插的|新秧苗$则|黄绿 柔嫩
卡尔扎伊的 表态$排除了|一个 障碍
规定 奖金$必须 奖给|主创 人员
发现|有罪 判无罪$或|重罪 轻判的
在|穆斯林$庆祝|开斋节的 当晚
请您 告诉我|您的 卡号$和 密码
图为|该市 翠屏区|菜坝镇$果农|喜收 脐橙
尸体的 双肢$遭|砍击的 伤|非常多
群众|最担心的 是$虎头 蛇尾
同时 随着|社会的 进步$而|悄悄|发生 变化
使|喜光的 草本 植物$能够 安身
相互 补充|相互 依存 关系$日益 加深
欣赏|美轮 美奂的$木雕 艺术
并 发表了|张炜 外省书$泪透 纸背的 长文
有如|北宋 司马光$著|训俭 示康
头顶 是$陡壁 翠峰|和|一望 无垠的 蓝天
那|若深 若浅$若有 若无的|缤纷 中
大伙|听了他$幽默 通俗的 演讲
跨马的 健儿|在$歌声中 飞跑
停止|对 这些$印度 紫檀的 摧残
应酬|也不能 过繁$过杂$过度
美国 经济$从|疲软|走入了 衰退
廷桂|真是比$亲闺女 还亲呀
婆媳|姑嫂|妯娌的 关系$复杂 而 微妙
二十岁的 邱俊贤$丈二 和尚|摸不着 头脑
他 陪着|勘察队$跑遍了 上庄的|沟沟 坎坎
因而|被 马蜂$见缝 插针地|蜇中 脖子
青春$正|如此 美好|和 绚丽
我们|真诚地 希望$普法 标语的|杜撰者
都会|爱护 关心$子女的 成长
莎翁|处于$欧洲|文艺 复兴 时期
文学的 热闹$只是|圈子里的 热闹
彩色灰$是以|灰色调 为本的|复合色
批评 别人|怕伤 和气$结冤家
塞明顿的 信$讲明了|这样 一个 道理
森工 总局 局长|邵树云$告诉 记者
咱 神池县的 老百姓$都 不知|咋 过呢
朋友 问我$莫斯科 有|多少 人口
不再 有$吃喝 拉撒 睡的|庸常 负担
密切了 党$同|群众的|血肉 联系
七弯 八拐地|堆积了 许多$概念 知识
不遵守 信用$才算|有 能耐|会 算计
趵突泉$平地 涌出|三尺涛的 胜景
回避|超短裙$百褶裙$碎褶裙 等
但 经验|和 教训$也|积累 不少
姑娘的 情郎|玛塔 考瑞$紧追 不舍
徒步 走上 五楼$耳鼻喉科 门诊部
徐帆$斯琴高娃$郭宝昌 主演
污水|漫过 沟渠$就往|耕地里 流
我们|碰了 一个$不软 不硬的 钉子
两年前$患了|运动 神经元|衰退症
三万吨 绒毛$和|冷储|十吨的 能力
经过|艰苦的 跟踪$和|明察 暗访
倘若|任尕海湖$偷捕 滥捞 行为|继续 猖獗
秋天的 牵挂$有 很强的|现实 针对性
体现了$足球|从 娃娃|抓起的 决心
招行|可望 在年内$通过|证监会的 审批
林子里 套种了|沙打旺$等 饲草
叶江川 击败$等级分|为 十分的|范威利
对|矛盾 纠纷|早 排查$早 发现$早 掌握
不少 农民 听说$苦咸水 养虾|能 挣钱
为|特困 群众$捐款 捐物|四万元
以|购买者的 身份$向|店员|询问 此事
长袍 马褂$花拳 绣腿|满天下
霍邱县$姚李镇$迎岗村$中寨 村民组
更 涉及|熊小伟$触犯 刑律的 问题
但 我|并未 动摇$对|锅巴菜的 钟情
有的人 干脆$公家 有啥|咱 拿啥
新战士|姚顿平 家里$因|宅基地 纠纷
希望|购买者$切莫|贪图 便宜
拉客|甩客|宰客 现象$基本 匿迹
张艾虎|继承 父亲的$未竟 事业
使之|更加 贴近 实际$而|便于 操作
我|沸腾的 心潮$将那 刺痕|彻底 荡涤
在 血海中$经|蝶窦 向|颅底 挤压
那样 只能$东一 榔头|西一 棒子
曾|赞助过$中国 奥运|跳水队
将|劣质 柴油$变为|优质 柴油|和|低 凝柴油
纺织是$不落 产业|永恒 行业
图为|龙胜 梯田$一派|丰收 景象
贱民 改宗的 浪潮$此起 彼伏
澳大利亚 选手$杰奎伊 邓恩|以
分|军旅 篇$花鸟 篇$山水 篇$人物 篇|四部分
还有|多少 归了$重新 出山的 老将
好将|自家 驴唇$撂在|前头|驴 屁股上
山 会把|溶浆般的 愤懑$喷发 出来
就|易于 为人|抓辫子$扣帽子$打棍子
当 罗马人|最终 攀上$和|攻破 城墙时
其中 还找到|孩子的 乳牙$和|下颚骨
而 不像|美英 那样$喜欢 摘桃子
我想|随便 喝点 稀汤$就 算了
现在 想$先买 一辆|旧的 小车|练练手
我 请了 一位|老师傅$来|帮忙 挑车
趴在 飞机上$用|耳朵 仔细地 听
领队 莫里 耶尔卢沃$对|记者 说
牡丹 萝卜丝$是 水席的|第一道 菜
青藏 铁路|一九八八年|四月 三日$铺轨|至 望昆
明年 开展|氟里昂$替换 工程
一些|久经 沙场的|老将们$老而 弥坚
而且|总 拎着 一个$鼓囊囊的 公文包
就是 缺少$敢抓|敢管的 干部
白天|不仅 忍受着|古书$发出的 霉味
包括|四节|软席 车厢$和|十六节|硬席 车厢
八匹 赛马$如|离弦 之箭 一般|蹿了 出去
黄黄的 烧饼$慰劳|忙哟 过去
仿佛|醉酒的 美姬$舞着|迷狂的 衣袖
军 代表|侯秉龙$接到了|退休 命令
一向|臭若 狗屎$无人 肯沾手
播出 时间|满打 满算$也才 十分钟
演唱者 名叫$乔治塞 邦尼迪斯
徐福|过之的 遗迹$在|正房 瀑布
是 俗称|老鼠街的$金凯 商业城
官司 以|该医院$败诉 赔付|而 告终
小吴鹏$说话 老爱|眯缝起 眼睛
在 梦中$也要|吮一吮 唇吻的
搁一撮 虾米$和|干笋丝 在 尖儿
烫干丝|这个 行当$全由|堂倌 包办
你看 他|这边 瞄瞄$那边 瞧瞧
为咱 请来 那$点|状元的 魁星
潜台词|赤裸裸$丝毫 不掩饰
该操的 心|所领导$都替 我们 操了
愤怒地 诉说$他们|遭遇的 困境
他就|不会用 歪的 邪的$来|讨你的 喜欢
一群群的 白鸽$在|高楼 大厦的 顶端|翱翔
西雅图的 失败$未必|算是 偶然
挥洒着|绿 与 黄的$壮丽 篇章
父亲的 头$就 开始|晕晕 乎乎的
巧妙 构思了|王婆 卖瓜$不用夸
续写$先祖 谱就的|磅礴 诗篇
心里 没有 一番$痛苦 煎熬的|争斗 抉择
著名 指挥家|大贺 典雄$突发 脑溢血
透过 闪烁的|灯光 水花$和 火花
此次|共 抽查了$十五家 企业 生产的|一百 批次 产品
磷酸盐|无机氮的 入海量$分别 削减
在|粗大 干枯的|树干上$昂然 伫立着
这位|身材 魁梧的|州长$自豪地 说
美国 记者|是$热衷 追逐|坏 消息的
而 无论是|睾丸素$还是 麻醉剂
她 找到|飘柔 产品 所属的$宝洁 公司
后在|广东省 打假办的$督促下
她 拿着|棒槌$追赶 那条 狗
荡涤了|旧西藏 社会的$污泥 浊水
当|党中央 率|一三军团$单独 北进
连|敌人|都 乖乖地$听他 调动
为|早夭的 外孙女$降了 半旗
每天 摸爬 滚打$居然|挺 过来了
拿着 一根|烧着的 柴$点 着了 烟
使|昔日的 莽莽|荒坝$变成了 万亩 良田
库尔斯克号的|毁坏 程度$惊人
十五的 月亮$就是|很好的 典型
那 将是$多么|幸福的 事情啊
他仍|一瘸 一拐地$拼搏在|训练 场上
把 一个|庞大的 机床胚$收拾得|服服 帖帖
路上|耽误 几小时$甚至 几天的 都有
指使 打手$用 砖头|将|民工 砸走
这伙人 用|棍棒 等$将 艾建国|打昏 在地
民主 阵线 主席|恩达达耶$当选 总统
宣威 火腿|是 曲靖的$百年 品牌
在 暂停了|对|喀布尔 天的 轰炸后
它 虽然|以 梨园$真人 真事|为 蓝本
它们|肆无 忌惮$优哉 游哉地 会餐
撑得|肚皮 紧绷绷$大葱 蘸酱
老包|肯定 是个|聪明 绝顶的 人
像|猴一样 活泼$兔子 似地 蹦跳
在|民警 一番$苦口 婆心 劝说 下
他们 用|手绢 绳子|勒着 脑门
大大 咧咧地|走进 屋内|坐下
该 摸出的$痞霸 分子|摸不出来
摆着 刚从$新疆 带回的|纪念品
随着|贸易 逆差的 扩大$和|经济 减速
让 孩子|荡荡 秋千$踢踢|北宋 足球
风情 独具的|宋都 景区$呼之 欲出
在|月夜的 燕飞$和|庄稼 摇摆的 舞里
给 爷爷|捎点|什么 好吃的呢
他们 在$各自|无法 逆转的|挫折中
他 送 我们$先乘 竹排|逆水 而上
那|绿茸茸 草坪上的$大牛皮鼓
板仓的 乡亲们$都|称您为 霞姑娘
这块 肥肉$看起来 令人|垂涎 欲滴
老百姓|能|不戳 我们的$脊梁骨吗
受|中共 北方局 书记$李大钊 派遣
她 这人$出手 很 宽绰的
情况|比 我们 预想的$更为 严峻
浦西 外滩的$十幢 楼顶的 焰火
弯弯的 月亮|是一首|怀旧的 抒情歌
他们|早已 跟 总台$或 老板|打好 招呼
而且 是在|入席 前的|单独 交谈
锥子型 长裤|采用|粗花呢 或缎子
受 冷空气|和 弱暖|湿气流的 影响
有的 怕|查了 案子|乱了 班子
有 浓浓的|乡情|缓慢 你的 步速
辛勤的 汗水|赢得了|丰硕的 回报
一垄 一垄的|队列|整整 齐齐
邵炜刚|负于 韩国 少年|崔哲瀚
除了|大量的|粉尘 噪音 污染 之外
被|剥了 皮的|红豆杉|必死 无疑
消息|和 通讯的 一等奖$各|空缺 一篇
他们|恰到 好处的 艺术 夸张|和 变形
在 福州|鳌峰洲的 一处|加油站
逐步 淘汰|刀耕 火种的|落后 农业
卡诺|也曾 举行过|反美 游行
他 一边 估算|白玛家|新房的 面积
那时 住的 房子$比 牛圈|好不到 哪去
还 不时|歪起 脑袋来|瞅瞅 我
一条|胳膊 粗的 毒蛇|赫然 盘在 那棵 树上
拼死 拼活地$把 他们|拖出来
寂静的 时光|也 燃烧着|天籁的 坦荡
怀揣 黄河 岸畔|永恒的 涛声
对 明星的 称呼|也 吹捧得|天花 乱坠
西安的|高雅 娱乐 餐饮$又 赚个|钵满 盆满
你 想让|白发 父母 送你|黑发人
我就 不能当 糊涂官|窝囊官
华佗 与|关羽$曹操|与 华佗 之间
那里 埋葬着 不少|为国 牺牲的 将士
还有|横遭 不测的 总统|肯尼迪
怪不得 王刚|在 文章中|悲哀 又|无奈地 说
村民 跟着 种起了|扁豆$葡萄$西瓜
现遭 砍伐|或|濒临 死亡的$已有 近百棵
已有 缺氧|睡不着 觉的 感觉
在他 生前|床前 小柜的 两个|抽屉里
必将 给|税收 征管|造成|更大的 混乱
曾经|脏乱 黑差的 列车|变了
使|配属的|十四辆 绿皮车$达到|六全 八有
才能将|腐朽的 东西$埋进 坟墓
划清 寻租 扭亏|同|经营 扭亏的 界限
被 钱塘潮的|雪浪 惊涛$震撼 陶醉
上面 说的 是|面广 量大的 案例
流淌在|错错 落落的 鹅卵石上
想|什么 时候 飞$就 什么 时候 飞
吟颂 出|多少|响遏 行云的 篇章
故乡的 恩惠|是 难以 忘怀的
小寨的|锣鼓 皮影 秦腔 和|棋牌 比赛
一位|高位 截肢|脸色 憔悴的 伤残人
柴可夫斯基|告诉 他的 侄儿$达维多夫 说
大家 吃完 以后|带点 东西|给他 吃
指着 上面 画的|勾勾 叉叉|向我 请教
还|摆放着 一盆盆|青翠 欲滴的 竹子
害怕 脏水$明天 我们 还敢|吃 什么
局 领导 班子|敢于 喊出|向 领导 看齐
终于在 文馆 东街$一把 扭住了 歹徒
冻得|缩在 被窝里|筛糠 似的 打哆嗦
开始了 他|永不 停歇的|思考 探索
形成了|收猪 运猪|屠宰 卖肉 一条龙
找个 小诊所 看看|或|干脆 忍着
赠|钱学森 大火|无心 云外流
不仅 需要|快刀 斩 乱麻的|干脆 利索
不怕|刺 剐破了 衣服|和 手脚
直到 满屋子|都 飘出 粉糍粑|浓浓的 香味
愿 音乐 排行榜|能够 少些$更 少些
让|嘉宾 出丑$拿 孩子 开涮|大谈 性爱
鼓吹|文明 冲突论者$把 差异 绝对化
具有 较强的|耐旱 耐热 耐寒 性能
上班 东摇 西晃|甚至|打牌 赌博 现象
如 哈佛|哥伦比亚$普林斯顿 等
我 羞愧得|恨不得|扒个 地缝 钻下去
当|月光 娘娘|洒下|第一层 银纱的 时候
我|不再 唱 那支|哀婉 悲楚的 歌
那 神圣的 一票|岂不 成了 儿戏
必须|丁是丁 卯是卯地|严格 执行
竟|同时 患上了|胆囊炎|胃炎 和 肾炎
一直 笃信|法轮功的 婆婆|突然 去世
馆藏 档案|已经 整理 编辑|出版了 三种
这种|坐地 收银的 买卖|谁 不干呢
男孩 用手|抚摸着 那沓|高高的 稿纸
吃亏 以后|又该|谁跟谁 算账呢
当 谢军|卧薪 尝胆|卷土 重来
几个 战士|在 映心 湖边|洗脸 擦汗
大胆地 试$大胆地 闯$大胆地 干
把 墨西哥|排除在|扫毒 评估 之外
砸锅 卖铁|也要|还清 欠缴金
袜子|由 哪里 制造$也许|并 不重要
并 协商 采取|更加|务实的 措施
是|人类 历史上|罕见的 反人类 罪行
车队 在|浑沌的 云气里|盘旋 而上
妹妹 歪着|扎了 两个|小鬏鬏的 脑袋
凭着 对|神经 解剖的|烂熟 于心
在 医院 里|转来 转去|晕头 转向
脏兮兮|臭哄哄的|鸡粪 拌 麦秸
二怕 得罪|国内的|富翁 犹太人
二审|改判 杨勇 死缓$并无 不当
而|自家的 三亩田|却|无秧苗 可栽
就|没有 曹禺的|扛鼎 之作 雷雨
果断 决定|对|锦州 硫酸厂|租赁 经营
就在 省局|打假 人员 凯旋|回 合肥时
我的 心|也 随着 燃烧|而 燃烧 起来
将|键盘|斜放在 桌面 与|抽屉 边上
当地 富豪|吴家|横插 一杠子
巨能钙的 广告$在那儿|可着 劲地|瞎 嚷嚷
在 那里|互相 吹捧|扭捏 作态
泰顺县 龟湖镇|盛产 叶蜡石
一朵|鲜艳的 雪莲|盛开在 新疆 东部
吴雷廷的 口头禅 是|做 领导
反复 琢磨$怎样 建一个|背篓 公寓
才能 懂得|歌词中|隽永的 意味
在 拉萨 停留的|短暂的 两天里
当他|趔趔 趄趄地|摔倒的 时候
至于|该不该 割去|右肾的 问题
孩子 错了|能|一棍子 打死吗
靠 管 环保|吃香 喝辣 赚票子
连|炊事员 勤杂工$都|跟着 陪绑
是|瓜农 和|跑运输的|受了 损失
孙银姬|从没 奢望过 拿冠军
李桂英|回娘家 遥桥峪|看她 二姐
豆粒大的 雹子$砸在 车窗上|噼里 啪啦响
操着 粤语的|冼东妹|一脸 轻松
五十 多岁的|郭老汉$摸着|茁壮 成长的 巨桉
复修的 亭台 楼阁|皆为|仿宋 建筑
本来|就 腼腆的 刘欢$怕|遭到 拒绝 没面子
随着她 一个|又高 又飘的 跟头|稳稳 落地
虽然 将 老夫子|后脑壳的 发辫 去掉
彩虹 志愿者们$又|怎能 绽放|绚丽的 笑容
它们 以 驴嘶$狗吠$猫叫$鸡啼|齐声 奏乐
犯了 事实上|和 逻辑上的|双重 错误
凌空 而下的|瀑布$卷起|千堆 雪花
一幅幅|巨大的 黄色 绸布$翻翻 滚滚
一阵|飘渺 悠远的|音响 声中
向 浩淼的 宇宙|发出|好奇的 探寻
铁岭 素以|辽北 粮仓|闻名 遐迩
公安部 发布|通缉令|通缉 曾汉林
拍拍 肩膀|说声|好好干 了事
一位 研究者|夸大$乃至|捏造 成果的 动机
在 牧野|大败|商纣王的 军队
垦区 奶牛|肉牛|生猪 存栏|增长 很快
青年 农民 马翠花|羞羞 答答地 说
刘银昌 揣上|烤 苞谷棒 玉米
渴了|就 把嘴|凑到 石头 缝里|喝 山溪
体操|训练 馆里$高挂着|这样的 横幅
王掌柜|在 怒斥 小唐|铁嘴 时
但 平时 除了|偶尔|踢踢球 外
降低了 乐园 搞|狂欢夜 活动的 风险
陪你们 来的|叔叔 阿姨|跑 第二棒
从不|敲锣 击鼓|鸣鞭 放炮|祝贺 庆典
真有|酒逢 知己|千杯少 之感
坚定 不移地|清除|腐朽 丑恶的|文化 现象
大大 缩小|冷藏时|降温的 幅度
凸显|人大 法理型 权威的$必由 之路
于|三月 三日 下午$匆匆 参拜了 那个|靖国 神社
颓废 无聊|荒诞 等|构成了 主调
气得 这位|县领导|拍着 胸脯 说
紧邻的|土不禅村|却是 另一番 景象
村委会 主任|张挨俊|眼泪 汪汪地 说
充满了|浪漫 而|光荣的 畅想
洛桑 扎西|和 鲁康娃等|留在 拉萨
仙妮蕾德 董事长|陈得福|赶来 北京
他 出院 时$和 护士|张鹏 阿姨|难舍 难分
为了|尽 可能地|保存|国内 资源
他 成为|今晚|唯一 跳过|十米的 选手
在饭里 埋几颗|酸萝卜|酸红 辣椒
引发了|左边 黑棋的|生死劫
面粉 米粉中|掺用|甲醛 漂白 增韧
网易|虽然 暂时 躲过|停牌 一劫
陈德聪|在 参加|坡脚 水库的 抢险中
你们的 规划 是|坡地 改梯 土梯田
张瑞敏|几乎 没有 什么|业余 爱好
至于 散溢着 墨香的|砖头厚的 小说
草木 葱茏的|新兴 旅游|城市 格局
生活的 激情$在 凤凰的|翅膀上 延伸
如何 炮制 诺言|罪恶|和 灾难的 人
缴获了 一大批|枪支 弹药|和 赃款 赃物
胡鸿飞|一九九八年 因患|鼻咽癌 退休
忙着 帮俺|造林 栽树 养畜|种 科技田
王的 亲属|却 对此|耿耿 于怀
周五连|让 侄子|拿相机|拍 自家 家具
就要 随时|把 脑袋|拴在 裤腰带上
雷达 兵们|喝上了 清澈的 井水
政府|悬赏 捉拿$也 奈何她 不得
遇到 一些|纠缠|和 麻烦|也是 正常的
城里 买不到|这么 便宜|这么 新鲜的
并 取得|飞入 或者$飞出 领空的 许可
范帆 领着 未婚夫$回|金华 完婚
姐姐|给您 领回个|党员 女婿
我们 要|举家 迁离|绿意 渐浓的 赣州
薄薄|灿灿的 煎饼|就 出来了
是 一位|患了 血癌$从|江苏 来的|美丽 少女
该 光缆|与 拉萨|日喀则|昂仁 光缆 相连接
也 有的|纯粹 是为了|捞 票子
那位|怀抱 孩子的 母亲|算|个子 高的
各种|甩卖 吆喝声|不绝 于耳
于是|我们 便 决定|包顿|荠菜 饺子 吃
接培勇|彻底 成了|赖昌星的 俘虏
吐着 黑烟|同时 又|喇叭 轰鸣的 车辆
赛马 场上|嘛呢旗|迎风 招展
他们|拆墙 透绿$见缝 插绿$拓荒 造绿
村里的 渔民$历来有|朝奉|妈祖的 习俗
王慧敏的|长篇 新作$各奔 前程
在对|大量 材料的|剪裁 取舍中
困难 再大|也|不能让|子弟兵 皱眉头
可见 用|很粗的 黑笔 写的|传呼 号码
地球的|旮旮 旯旯$无不 弥漫|它的 气息
解决|欧美 在|这个 领域的 矛盾
应该|煮熟 炒熟|或 炸透后 再吃
抨击|恶俗 与 虚伪$粗糙 与 平庸
一起 灭绝 人性的|抛尸 灭迹 闹剧
各家 分店的|菜品 质量|差异 明显
依靠|不依赖 慢走$一步 差之 千里
同时 穿插 六组|三十六支 插曲
少不了 闹出|乔太守|乱点 鸳鸯谱的 笑话
还 呲着嘴|发出|吱吱的 怪叫
两米的 赵蕊蕊$独自 在一旁 练球
不少|行家 认为$俞斌|败局 已定
他们|无暇 顾及|或|不屑 一顾
苏伟|奉命 带领|三名 战士|设卡 搜查
丧心 病狂的 歹徒$挥舞着 砍刀|拼命 逃窜
什么|深奥 玄乎$就贴 什么 标签
他 顽皮地|将 蟒蛇|缠在了 脖子上
他 是|旧西藏|噶厦 政府的|噶伦 昌都 总管
出差|舍不得 住|像样的 宾馆
上面的 花纹|已经 模糊 不清
可是 弄不 明白|共党|是 干什么的
让 那些|匆匆 赶路的 红军|润润 嗓子
我们 村里|去年 烤烟|病虫害 严重
第三盘|恩奎斯特 发起 反击
它 唱响了|西柏坡 精神的|最 强音
一口气 买了|多个 馒头|扛回 武昌
我们 应该|好好地$为人民 谋利益
侯锋 夫妇|比 勤劳的 蜜蜂|还 勤奋
他们 抬着|青松 扎成的 匾额
矿工们|过着|牛马 不如的 生活
炯炯 有神的 目光$和|逻辑 缜密的 谈吐
老人 紧攥着|共和国|寸步 不让的 尊严
衬衣 也是$补丁 摞 补丁的|粗布 衬衣
演惯了|跑圆场 甩水袖的|传统 女性
江姐的 唱腔|设计得|颇有 新意
认为 有些 东西|无非是|说说 而已
户口本$粮票$介绍信 等几样 东西
以 本民族|灿烂 悠久的|历史 文化 为自豪
叙在黎的 影响$不会 因此 而 削弱
他 不顾|术后的 疼痛$及|刀口 感染的 危险
冠以|话剧 头衔的|切格瓦拉
足迹|遍及|全县 三个 乡镇的|村村 寨寨
只好|偷偷 摸摸|打 一枪|换 一个 地方
一群群 雪白的 绵羊|在 草场上|觅食 撒欢
但|见怪 不怪的 冷漠圈|困扰着 我们
奶奶|在 父亲|六岁的 时候$病 死了
进一步 巩固|铸造 军魂的|组织 基础
和 梭子 鸟儿$在 草地上|抢夺 食物
我 仍然 往小院里|撒抛 米谷
播散 花棒$杨柴$沙蒿$柠条 等种子|五万 公斤
一亮相|就 免不了|浅薄 粗糙|与 粗俗
从而 提高 砖头的|保暖|和 隔热 性能
父亲 摸摸 我|额头上的 马鬃
收获着|血火中 耕耘的|丰硕 果实
唯有|将军城|和 闯爷牌的 烟草
而把|需方 领到 码头|货场 或 仓库
海上 巡逻艇|加大了 巡逻 力度
阿航的|四套 模拟 驾驶仪|也都 卖掉
还是 免不了|压仓底的 结果
却有 变|二审 终审|为|一审 终审的 苗头
打算 晚上 找|党委 书记|提 意见
你|打听 打听|咱们连的 党员
实现|全转炉 炼钢|炉外 精炼|和 全连铸
有|直刺 云霄|挺拔 卓立的 孤松
尤以 伏旱|俗称 卡脖子旱|危害 最大
及早 做好|抗大旱|长期 抗旱的 准备
邰林|画家梦 破灭$子承 父业|干了 刑警
宾主 一起 吹灭|蛋糕上的 蜡烛
都让我 梦幻过$求索过$骄傲过$惭愧过
是 从|孔繁森的 口里|说 出来的
这种|釜底 抽薪|撤庙 搬神式的 改革
多吉家|拆了 原来|低矮 破旧的 住房
瞧不起|自己 祖宗的 人|算什么 本事
为我 遮挡|深冬的 寒流$仲夏的 滂沱 大雨
在|把脉 问诊|收了我 三元的|处方费 之后
那段|风云 激荡的 历史$恍若 昨天
修车铺的 主人|却|一问 三不知
我们 来看|董传凤的|血泪 控诉
第二天$他就 忙着|整地|铺草|浇水
全村 哪家的 麦子$都得|你 替他 割
腰上的 绳子|嘭地|断成 两节
给|春末的 汪清|带来|几许 清爽
塞翁 失马的 先例|也是 有过的
房间里$也 到处 扔着|大大 泡泡糖
读出|乌云 盖顶 般的|自卑感 来
这几座 难民营 中的|在校生|约 一百名
争取|亏损 企业|亏损额 减 一半
为 鸟儿$燕儿$云儿|铺上 一片绿
争创|一挂 双定|挂|共产党员 牌
老厂|屁股 底下的 那块地|值钱了
几乎|天天 奔走在|鄱阳湖的 草滩 上
像是 挨了|一闷棍后 有些|懵懵 懂懂
鞋 掉了底$脚 打起泡$脸 刺破皮
一寸寸 一点点地|爬过|蛇 倒退
卧虎 藏龙$不是 一部|多么 好的 片子
都 那么|彻底地 洗刷了|灵魂中的 污垢
就是 找准了 调调|再去 弹奏的
这 三怕|正好 说明了|民主日的 效力
本打算|抽调 张玉宁|和 曲圣卿 来
界碑的 南边|墨西哥 一侧 写着
奴才 靠 谎话|能有|多大 作为
别让|算命 先生|败了 游人的 兴
如果 不是|什么 好规矩$正经 规矩
摸出 枕头 下面|二十七块 六毛钱
孙海军的|亲家 弟弟|上山 植树
就|央视 正在 筹拍|射雕 英雄传 一事
帕瓦罗蒂的 嗓音|丰满 充沛
在 通往|云溪区 公路旁的 农田里
邱汝舜 拿着 说明书|和 线路图
毛泽东|入乡 随俗|勾掉 债款 烧借条
欢乐 山寨|百鸟 朝凤 等乐章|响彻 夜空
滚滚 黑烟|呛得人 喘不过 气
呼呼 喷出的|焦粉 熏得人|头晕 目眩
她|十岁 那年$便 扛起 道锤$拿起|撬棍 扳手
他 率领的|总装班|装配 整辆车
用 左手指 掸了掸|上面的 灰尘
如果 仅仅是|经贸委|取消 审批了
只有|不畏 劳苦$沿着|陡峭 山路|攀登的 人
它就是 当年的|安徽|蚌埠 柠檬酸厂
他们 有的|和 乔宗淮 大使|紧紧 拥抱
朋友们|劝他 换个|宽敞 舒适的 住所
行家们|一致 夸奖她$打球 有灵性
坐在|前边 车斗的|导游 小姐 喊起来
逮捕了 教主|麻原 彰晃|和 一些|骨干 分子
看着 答题者|眼睛 瞪得 像灯笼
来拉 俺们 产的|苹果 核桃哩
这尊 石雕 造像|二十 世纪|七十 年代|被 凿掉
如今 搞|费改税$是|政府 立规矩|保护 咱呢
咱 不甩开 膀子|干点 名堂$还等 啥呢
大学 招生中|各种 条条 框框
媳妇们|边 刷碗 抹桌子|边听 婆婆 说
一九九七年 退了休$我就 回了|贵州 毕节
我一定 还要 看看|欧阳的 存折
谢阿银|谢海云|谢品杰|中途 退场
你从|什么 地方 学的|佛呀 魔呀|这些 东西
有 红椰|青椰|水椰|高椰|良种 矮椰
是否 都会在|喳喳 礼赞声中 死去
直到 现代的 邮品|门券|烟标|粮票|磁卡
摁着 六号 队员|开心地|哈哈 大笑
我们 吃过|市场 混乱的 苦头
血水 顺着 裤脚$滴滴 答答|流到 地上
气急 败坏的 歹徒|哪听 我的 恳求
达到 全团|开得动|打得准|联得上
而|舆论 监督 是|跨 区域|跨 空间的
沧州市 在|农村 纠纷 排查中
成都 郊区|赏花 规模大$新增 景点 多
在 哈尔滨 北环路上|挥锹 抡镐
是 美机|左翼 外侧$先 撞击 我机
而 翠绿的|蒜薹 截儿$嫣红的 腊肉 片儿
竟然 端起 空碗|向|嘴边 送去
干巴|发白的 土垄$一踩|就是 一个坑
麦子的 叶子|不是 都死了吗
古亭 曲廊前 几张|风姿 绰约的 倩影
市场 炒作|清理 库存的 成分 居多
有的 学大人|穿金 戴银|并做|痛苦状
事情 本身|就 显得|颇不 寻常
穿着 一件|紫绛红的 薄绒|翻领 毛衣
警察|抓 小偷$斗 歹徒$见义 勇为$奋不 顾身
可 家里|冬天的 取暖煤|还没 着落
鬼神 迷信的 沉渣|重新 泛起
警告 那些|吸吮|炭鬼 之血的 魔鬼们
有的 乡亲们|脑瓜子 开窍早
王玉顺 郝凤琴 侯怀英$于|二零零三年 九月
刘家沟的 村民们|吃 棉花壳|玉米芯
买|这种 打折 机票|才 更合适
头上 捂着 一顶|随时 飘落|狗毛的 皮帽子
我 这个 来自|偏僻 矿区的 小盲流
不准|大操 大办|婚丧 嫁娶|借机 敛财
这次|人口 普查的|人口 漏报率 为
不能 干|亲者 痛|仇者 快的 事了
医院 乱收费|啥时候 能 改一改呀
而|电话 骚扰|门缝 广告 等行为
对 漏提 请批捕$和 漏起诉的|依法 纠正
吕斌的 妹妹|吕佳$也到|镇里 上学
以|湖边的 爬虫 青蛙|和 小鱼虾 为主
人称|八大 金刚的$八个 代表|吵啊 扯啊
青青 小饭桌的 牌子|就|挂了 出来
缩小 脑血栓 患者|脑梗塞 面积
小民的 兵 也给|凯达诺夫|吃个 精光
全省|共 捣毁|非法 炼制|土炼油 窝点 十个
咱 一起 溶入|反腐 倡廉的 怒潮中
夫妻俩 泪流 满面地$向|单荣范 哭诉
一会儿 说$地球|真的要 毁灭了
每个 毛孔|都 滴着|血|和 肮脏的 东西
吉林省 春耕|备耕|抓得 早|做得 实
狗儿 一颠 一颠地|紧随 主人
挫败了|西方|敌对 势力|搞垮 我们的 图谋
一条 一条地|批判 其|歪理 邪说
乐凯 民族|工业的 大旗|能 扛到 今天
他们 对 伊拉克|和 萨达姆|充满 仇视
安抚 盟国$鲍威尔|欧洲 之行 浅析
满肚子 委屈|一古脑|倒了 出来
该让|咱 这把 老骨头|去 换他啊
癌症的 病痛|更是 像|刀割 一样|折磨着 他
标志着 党的|文化 使命感的 增强
把 木桶 制成的|粪坑|挣 破了
有的|甚至 只是|走走 过场 而已
山东省 聊城市 公安局|东昌府 分局
决定 减交|免交|缓交|诉讼 费用
在 床前|哭成了 泪人的|母亲 问他
打着|真的 旗号$兜售 邪的 货色
中国 戏剧 戏曲|久久 走不出 低谷
有|怪腕 之称的 王磊|出现 误算
绑匪 逼迫|艾某 打电话|通知 家人
一些 抽屉案|口袋案|一拖 数年
数百只 沙鸥|贴着 绿波 戏水
每一家 美容 美发店的|玻璃 门窗上
并|继续 稳居|通信 制造业 榜首
疯牛病|是 牛海绵状 脑病的 别称
粮食|虽然 比 以前|调减了 不少
当他|生命 垂危|从|昏迷中 醒来时
次仁 卓嘎|雪域 高原|阿妈 妮妮
此次 汉王|把 秘密 武器|转让给|恒基 伟业
发表的 看法|也 令人|茅塞 顿开
每天 晚上|孙教授 测完|血糖 尿糖
不久前$王庚 和 爱人|到娘家 走亲戚
卖胶卷的|分不清|反转片的 种类
甚至|不揣 冒昧|上书 邓小平
一位 知识 渊博|温文 尔雅的 政治家
对 房屋的|抗震 质量|漠不 关心
正碰上 女主人|在摘 鲜嫩的 黄瓜
借此 机会|还要 搞什么|挂牌 仪式
王文跃|虽 听说|要办 采伐 手续
空留|光秃秃的 树根|在 哭诉
不仅 以|有跨度|有深度的 内蕴
层层 码好的 糖片|脆嘣嘣的
我 这把 老骨头$早就 埋在|太行山了
三升的 雪碧 饮料|塑料 瓶装 汽油
他 拐着|伤残的 腿$扶着 手杖 上阵了
同时 挖塘泥|和|积造 农家肥|十多 万担
旁边 题写着|毛主席的|卜算子 咏梅
金塔旁|几十尊 石狮|昂首 欲吼
路途上 遇到的|埃塞 放牛娃
便|平平 静静地|走完了 自己的 路程
票房 收入|也 一改 过去|亏空 颓势
唱着|猪啊 羊啊|送到 哪里去
歌德 将|蠢货的 头衔|还给了 批评家
憧憬|春潮 澎湃的|锦绣 未来
柳州 五菱|追账 压库|效益 攀升
也 有人|扯着 嗓子 喊|搭 把手的
电脑 也不是 什么|稀罕品了
我 喜欢 你|亲爱的 白雪 娃娃
衬衣的 领子$不可 过紧|或 过松
不论是|降价 促销|还是|稳价 热销
拎壶|苞谷 散酒$在 路上|逍遥地 走
胡锦涛 访 乌干达|抵 恩德培
板床|桌椅 棉被$都是 破旧的
挖成了|层层 叠叠的|多个 鱼鳞坑
能否 实现|美国 经济的|平稳 着陆
有些 棉麻 公司|套取 棉花|收购 资金
轮胎的 碎屑$被|气流 卷向 油箱
估计 希普曼|还会 咬住 死口
管锥 编的 增订|是|另册 出版的
他们 早已 喝得|醉醺醺地|撤向 大海
在 此次|价格 调整中$将|增设 诊疗费
眼前 利润|天差 地别|暂且 不说
让 失聪的 耳朵|聆听|鸽哨的 呼啸
为了 挖掘|陕北 剪纸的 魅力
至少|我 把心|留了 一半|在 你们 那里
芦丛中的 鸟儿|也 倦倦地|懒得 歌唱
让|拟 提拔者 情况|全部 示众
仓促 决定$于 二月 四日|召开 罢免 大会
计划 每周|二三五日|往返 飞行班
用|各种 装饰品|渲染 节日的|喜庆 与 祥和
管理者 认为$网络 安全 对|电子 商务的 发展$非常 重要
中国的|互联网 用户|虽然 有|一千万人
为了 推动|无公害 蔬菜的 生产
桔山 新区 工委$为 妥善 安置|失地 农民 就业
有 很多|广播 电视|信号 盲区
与 我县 拥有的|资源|及 应发挥的|作用 相比
是 我县|海洋 经济|走出|发展 困境的|内在 要求
围绕 海洋 经济|可持续 发展的 目标
把|发展 旅游业$作为 培植 海洋 经济|新的 增长点
实现 由|先导 产业$向|主导 产业的 转化
象山|大力 发展|临海型 加工业
产品 远销|日本|美国|韩国|欧盟 等国
使|象山 港口|跻身 全省|重要 港口 行列
石浦港$要 充分 发挥|二类 口岸的 作用
加大 水产品|等外贸 产品的|出口 运输量
局长 雷绍武|告诉 记者|一条 喜讯
很重要的 一条 是$一定要 搞清楚
政府 应该|干什么$和 怎么干
许可证 管理|克服了|种植的 盲目性
但 要为|七农 提供|技术 信息|和 资金的 扶持
必须 有一个|运转 良好的|中介 组织
过去 文山的 三七|从|种植 到 加工
三七的|药理 研究$不少|还处于 填空 阶段
三七所 拿出了 十二项|应用型 成果
三七所|承担了 其中的|技术 培训|指导 任务
云南 省政府|将 三七根|腐病 防治 项目$向 全国 招标
巩固 其|国内 三七 研究的|基础性 地位
但 一些 地方$并没有 完全 按照|国家的|有关 规定 执行
一些 地方 实行|先城|后乡 控制
城市 职工$本地 农民工|和 外来 农民工$存在着|显著的 差别
对|新成长 劳动力的 转移$产生了$不利的 影响
东部 沿海 地区的|中小 城市$好于|中部 地区|城镇的 情况
发现 各家的|青壮年|几乎|全在家 猫冬
是|村里 少有的 几个|常年 在外 打工的$青年人 之一
刚从 外地|回家 探亲的 小韩$感慨 颇多
不少人 也有过|外出 打工|闯一闯的 打算
不是 怕|工作 难找|白贴 路费
在一些|劳动力 密集型的 行业
老板 克扣|打工者 工钱|也是 家常 便饭
四是|县乡 政府|对 外出 打工 人员|缺乏 有效的 组织
好好|替我们 农民|呼吁 一下
村民们|满脸 无奈地|对 记者说
把|化肥 农药|孩子的 学费|一 扣除掉
村党支部 书记 马奶立$会计 刘安孝|告诉 记者
有 四成的 人|近半数的 时间|是 闲着的
省政府 又在|新疆 乌鲁木齐$举办了|川疆 劳务 洽谈会
为 集团化 输出|探索了 一条 路子
四川 目前|在 新疆 民工|多达|三万人 左右
在疆 资产|过 千万元的|川籍 企业家$至少在 十人 以上
四川省|积极 探索了|组织 方式的 创新
确定了|三个 劳务 开发 基地县$五个 外派 劳务 基地$和 十个|专业 基地
使其 按照|市场 经济 规律|统筹 就业
四川 选择 金堂县|作为 城乡 统筹|就业 试点县
为|农民 外出 就业|提供|前瞻性 引导性的|信息 服务
将|劳动力 市场的 管理$纳入 科学化|规范化|现代化的 轨道
通过 劳务 开发|这种 思想 观念|行为 方式的|洗礼 过程
一大批|有胆 有识的 人才|脱颖 而出
这些|率先|富裕 起来的 农民
夺得 男子 单打|和|女子 单打 冠军
中国 选手 张宁|获得|女子 单打 亚军
摘取 男单 冠军的 是|丹麦 名将 盖德
一直|状态 低迷的 刘国梁|再现|大满贯 实力
战胜了 新加坡|著名 选手|井浚泓
对 三名|骨龄 检测|超标 球员|作出 处罚
中国 足协|今年 曾|先后 几次|检测 球员 骨龄
并不是$非常 准确的|年龄 鉴定 方法
中国 足协|制定的 标准$容许 球员 骨龄|大于 填报 年龄
今年 另有 八人|经 俱乐部 和|地方 足协|自查 自纠
被查 和|自查|虚报 年龄的|青少年 球员$总共有 十人
中国 选手|连站到 领奖台上的|机会|都 没有
二十三岁的|中国 选手|王国章$抑制 不住 满脸的|兴奋|如是 说
公路 自行车 项目$是|中国的 弱项
如果 没有$窦阳 惠国|他们|拼了 命地|往出 带我
小伙子|今天 已经 把力量|全都 耗尽了
终于 取得了|梦寐 以求的 好成绩
看过 中国 自行车手|在 比赛中|团结 协作
再 看看 他们|为了 队友 出成绩$而 甘心做|铺路石的 磊落 心胸
大连 实德队|首夺|美心门 足协杯
国安队 外援|切尔梅利$得到|第二张 黄牌|被罚 下场
人数上的 劣势$使|国安队 陷入 被动
实德队 成为 继|山东 鲁能队后$中国 男足的|又一个 双冠王
大连队|三号 郝海东$与 北京队|十号 谢朝阳 争顶
由|英国 远程|诊断 技术 公司 开发的|远程 诊断 系统
这一 系统|为一个|橘黄色 小塑料箱
如|血压|脉搏|体温|血氧 水平 等
明年 下半年|石油 需求 将 增加
世界 经济|也将 重新|变得 繁荣
波士顿|决策 经济学 公司|经济学家$艾伦赛纳 称
美国|经济 网站的|经济学家|扎恩迪 说
复苏|也将是 一次|温和的 复苏
复苏 势头|就会|十分 令人 失望
零四年的|显著 特征是$非常 低的 增长率$和|很高的 失业率
巴人阵 领导人|穆斯塔法|被|以军 炸死
以|乘机 扩大|对 巴目标的|打击 规模
成功 安全地|坠入 预定的|南太平洋 海域
和平号 是|一九九九年 七月 八日$被 送入|太空 轨道的
它 围绕 地球|飞行了 一万 多圈$行程 九亿 公里
尼泊尔 王宫$纳拉扬希蒂宫$爆发|惊天 血案
重伤 昏迷的 王储$迪彭德拉|继任 国王
王储 婚姻|失落 等问题$造成|王室 内部|矛盾 激化
国际 奥委会$在 莫斯科 举行的|第四次 全会上$投票 确定
正 如|国际 奥委会|在|评估 报告中 评价
将给|中国 和 体育|留下|独一 无二的$宝贵 遗产
而且 也 有利于|中国 更快地|走向 世界
其中 两架|撞击 纽约市的|世贸 中心|双子 大厦
一架 在|宾夕法尼亚州 坠毁
锁定 在|阿富汗的|沙特阿拉伯 富商$本拉登|为|主要 嫌犯
两个 多月后|塔利班 政权 垮台
四月 六日$以 卡尔扎伊 为 主席的|阿富汗 临时 政府|宣告 成立
与会 成员 领导人$以 新世纪|新挑战
世贸 组织|成员的 代表$就 一揽子|谈判 议程|达成 一致
决定 启动|新一轮|多边 贸易 谈判|多哈 发展 议程
抵制 在|南非 举行的|联合国$反 种族主义 大会
美国 政府|对其 外交 政策$作了 某些 调整
发挥 对|税收 执法权$和 行政 管理 权的|监督 制约 作用
重点 剖析|地税 系统|发生的$渎职 犯罪 案件
辽宁省 锦州市 公安局$召开|返还|被盗 机动车 大会
不仅 增强了|各 机关 单位的$工作 透明度
多次 持|枪械 匕首 等凶器$聚众 斗殴
依仗|开采 煤矿 赚取的 钱财$和 所谓的 经济 实力
河北省 唐山市|公检法 办案 人员$排除|各种 干扰 和 阻力
公诉人|南宁市 人民检察院$指控|刘知炳|身为 国家 工作 人员
先后 九次$非法 收受|朱春鹤 给予的|一百万元 人民币
为|张思难的|请托 事项|提供 帮助
被告 刘知炳$于|一九九八年 至|二零零一年 之间
今年 以来|民政部 财政部$安排 下拨|中央 救灾款 共计
提高 对 做好|救灾 工作的 认识
武警 安徽 总队|坚持|选贤 任能
他们 都是|作风正$能力强$干劲足$魄力大的 佼佼者
并|严肃 查处了|收受 和|赠送 红包 礼金 案件
从 一九九七年 元月$至|二零零一年 十一月 底
给予|党纪 处分的|七百 六十一人
党支部|被 评为|全军 优秀|基层 党组织
他 就是 从|先进 单位的|领导 岗位上$奔赴|新的 战场
郑占云$又一次 走进|二炮 延庆|综合 仓库
这个 综合 仓库$担负|二炮 战役 物资|收管 发运 任务
郑占云|又把 目光|盯在了$仓库 物资|收管 发运的|科技 含量上
根据 二炮|跨越式 发展$对|物资 保障 提出的|新要求
后勤 指挥 学院$把|这里 作为$仓储 管理 教学|示范 基地
有个|中年 妇女$拉着 自己的 弟弟$找到 郑占云
随手 送上 一个|厚厚的 信封
来自|贫困 山区的|机械 分库 战士$赵中原
郑占云|把此 称为|仓库的$无形 资产
一款 由|西铁城|钟表 公司 研制的$光动能 手表
这款 手表|特制的 电池$可以将 光能|转变成 电能|并$加以 储存
发展到 纺织$服装$汽车$住房$家居等 人民 生活的|方方 面面
向|国务院 外经贸 主管 部门|申领$出口 配额 许可证
聘|著名 国脚 杨晨$为|品牌 代言人
聘请 杨晨$为其 品牌 代言人
将 有助于 三元$拓展 华北|乃至 全国 市场
曾经 亏损|九亿 多元$负债率 高达
水城 钢铁 公司|实现 扭亏 后
靠|技术 创新 开拓出|企业|持续 发展 道路
水钢 曾是|贵州省 最大的|亏损 企业
成为 我国|十大 扭亏|典型 企业 之一
水钢|分别 实现|利润 一千多万元
国家 对|大路货的 钢铁 产品|实行 限产
对 炼铁|炼钢 二轧$进行了|三大 技术 改造
他们 筛选出$国内 同行业|六项 先进 指标
全厂 职工|立足 岗位$大搞|技术 革新
公司|在 已实行的|成本 逆向|核算的 基础上
因|降低 成本|而 增加的 销售收入$超过 九亿元
也为 长江|中下游 流域的|治理$提供了|可 借鉴的 经验
别忘了|退耕 还林$退田 还湖$植树 造林等|生态 环境的 建设
不仅 关系到|能否 搞好|农业 结构 调整
根据|基本法的 精神$和|香港 回归的 实际
社论 题为|高扬 创新的 旗帜
促进 国民 经济|持续 快速|健康 发展$和|社会 全面 进步
正确 应对|加入|世界 贸易 组织后的$机遇 和 挑战
他们|高起点 建设|软硬 环境
连 猪饲料|鸡饲料|都有 假的
制约 本行业的|越轨|和 失范
中国的 徽商|也是 因为|有一套 完整的 规范
唯利 是图|是|造假的 一个 内因
严肃地 指出了$在一些 领导 干部中|弄虚 作假
很多 造假的人|就是用|只许 州官 放火
不许 百姓 点灯$来为 自己的|行径 开脱的
他 才在 下边|学着|干 假事的
但 又是有|千丝 万缕 联系的
非 抓出|成效来|不可的 地步了
埃博拉 病毒的 形状$宛如|中国 古代的 如意
病人 最终 出现|口腔|鼻腔 和|肛门 出血 等症状
一名 儿童$被 卖鸟|摊点的 小鸟|深深 吸引
这场 火灾$是由 一个|烟花 爆竹 商店|爆炸 引起的
伤亡者|大多 是 为了|欢度 元旦$而 前来|购买 烟花 爆竹的 顾客
大火 还 殃及到|附近的 十个|商业 街区
并 宣布|四日 和 五日 两天$为|全国 哀悼日
美军 战机|在对|阿富汗 东部 省份|帕克蒂亚$进行 轰炸 时
塔利班 及|基地 武装的 力量$还 没有 肃清
一些|非洲 国家 元首$参加了 葬礼
他被 安葬在|达喀尔的 一个|天主教 墓地
桑戈尔|之所以 作出|这一 选择
桑戈尔 是 塞内加尔|独立 后的$第一任 总统
他 于|本月 九日$在|法国 诺曼底 家中 去世
萨阿 总统|今天 与 他的|助手们$举行了 会议
讨论|对 内阁 进行|必要的 改组的 问题
赞扬|中叙 两国|日益 发展的 友谊
招待 各国 驻华 使节$和|国际 组织|驻华 代表|以及 他们的 夫人
唐家璇|在 招待会上|致 祝酒辞
全党 全国|将 满怀 信心地$迎接 中国共产党|十六大的 召开
俄 将 继续|同 中国 和 印度$发展 友好 关系
这 符合|俄中 和 俄印的|长远 利益
更多地 参加|亚太经济 合作组织 内的$一体化 合作
俄 将|继续 完善 与|白俄罗斯的 联盟 关系
俄美 关系|改善的 势头$明年|不会 减弱
出台了|对|污染 经济 环境 行为|实行 处罚的 决定
确定 首次|国家 司法 考试$于 明年 六月 一日$在 全国|统一 举行
首次|国家 司法 考试$采用|闭卷|笔试的 方式
每份 试卷|考试 时间|为 三小时
命题 范围$以 司法部 公布的|二零零零年|国家 司法 考试|大纲 为准
廉租房 深受|最低 收入 家庭的 欢迎
并 由此 而建立了|较为 完善的|住房 保障 机制
有效地 缓解了|资金 不足的 问题
不致使|廉租 居民|在 收入 提高后$继续 享受 廉租 福利
有利于 对|最低 收入者|这一 动态性 人群$实施|长久的 保障
在 北京|前不久 举行的|首次 摇号中$中号的 四户 家庭中
就是|王建国 王丽欣|一家 三口的 家
他的 儿子|王志强|已经 两岁 多了
看了 多处|中介 机构|提供的 房源
王建国 一家$每月 享受|政府的 廉租房 补贴|三百元
等于|不用 花钱$就 换了个 面积|大一些的 房子
已经 与 出租人|签订了|住房 租赁 合同的$多个 廉租户
采用的|大多 是与 王建国 一家|同样的$租金 补贴 方式
对 廉租户 采用|以 租金 补贴 为主$实物 配租 为辅的 方式
现有的 住房 公积金|增值 部分的 金额$只有|四亿元 左右
七万 多户 家庭|一年的 租金|都有了 着落
二是 从|方便 居住的 角度 考虑
如果 采用|实物 配租的 方式
可以 盘活|现有的|存量 住房 市场
有空时|帮 大人|为 搬家 作准备
城里的 老房子$正在|成片地 拆
不漏报|自己 辖区的|一个 双困户
走出|王建国家 所在的 胡同
大片 平房的 墙上$都 写着 拆字
有的 墙上 还贴着|精美的|商品房 广告
全国|各族 人民|紧密 团结|开拓 创新
中国共产党|第十六次|全国 代表 大会$将 隆重 举行
及时 如实|充分地 反映|人民 群众的 意愿
进一步 加大|党的 建设的|宣传 力度
每 星期日$由|三个 版|扩为|四个 版
读者 对|以上 版面 调整|有什么|意见 建议
工程 总投资|三十八亿 多元
比|去年 同期|增长 百分之二十
近 三年来$新马泰 旅客|对 南航 服务的 满意率$均 保持在|百分之五十 以上
其 国内|最大的|航空 公司 马航|全面 降价
南航 驻|吉隆坡 办事处$采取了|灵活 多样的|促销 手段
南航 曼谷 办事处$是 南航|最早的 一个 办事处
推出 曼谷 到|张家界$桂林$郑州$西安 等地的|多架 包机
新加坡 是 南航|第一个 推出|夜航的 地方
夜航 提高了|飞机的 利用率
吉隆坡 办事处|对 货运 代理|提出 要求
机务 经理|严格 按照|国家 民航局的 规定
重新 商讨了|有关 飞机 保安的|执行 标准
新加坡 航空公司|二零零四年 十二月份 运载率$下跌|三个 百分点
公务客 登机前|可以 舒适地 在那里|休息 用餐
使 航班|公务舱 旅客|从无 到有
在 送团的 时候|可以 密切 配合|飞行 工作
山东 无棣县|近日 开展了|查 假冒 伪劣
只有 一篇幅|是 介绍|九阳 豆浆机的
还有|大段的 篇幅|则 用来 介绍 豆浆
整理 编撰成|鲜豆浆 营养 食谱
天天 保健康的|健康 理念中
而我 因|没有 档案|未能 及时 参保
这时|我才 意识 到|事情的 严重性
用人 单位 在|解除 或|终止 与 职工的|劳动 关系后
从 整体上|提高 我国 企业的 竞争力
代替了|原本 属于 大企业的|内部 分工
为 他们 提供|低成本|高质量|多方面的|配套 和 服务
同时|也为 自己 争得了|更为 广阔的 生存$和|发展 空间
据|联合国 贸发 会议的|最新 统计
产值|占 全球 总产值的|百分之六十 左右
量大 面广的|中小 企业$在 激烈的 竞争中|也有了 长足的 发展
二是 缺少 有|竞争力的 大 企业
在 抓大 做强|和 放小 扶小 两方面|同时 努力
支持 有|竞争力的 大企业|跨国 经营
促进 中小 企业|重合同 守信用
加快 形成|大中小 企业|协调 发展的 格局
全镇 包村 干部$也 帮助 信用社|盘活|双呆 贷款|二百多 万元
靠 勤学 苦干|成长 起来的|青年 专家
把 锁在|档案柜 里的 廊坊杨$推向了 全国
我|获成果 晋职称的|狭隘 思维 定式中
廊坊杨 成果|长期 不能|形成 生产力
为 国际 首创的$幼龄 廊坊杨$一号 栽培 和$造纸 配套 技术的 研究
其中 三项$达到 国际 首创|和|国际 先进 水平
燕赵 大地|这片 沃土|哺育 了我
为什么 现在|交通 通讯 先进了
总觉得|自己 办事$是对|群众的 赏赐
坐着 车子 转转$打个 电话 催催
群众 却 得不到|半点 实惠$作风 如此 漂浮
而是 看你的|言谈 举止|像不像 自己人
其实|是 因为 你的|作风 不踏实$方法 不对路
反思|自身 存在的|缺点 和 问题
国土 资源 是|国脉 所系|民生 所依
必须 搞清|西部的 土地 和|矿产 资源$及|地质 环境 状况
开展 地质 灾害|动态 监测|和 预警 预报
国土 资源的 特殊性$决定了|必须 加快 实现 信息化
具有|种类 繁多|属性 各异|数量 巨大$管理 复杂的 特点
窗口式 办公|取得 良好|社会 反响
正在 实现 全国|多级 勘探 登记$采矿 登记 工作的 信息化
信息 技术 在|国土 资源|调查 评价 工作中$得到|较好 应用
数字化 信息 积累|有了|较大 程度 提高
建设|先进 可靠的|信息 网络
在此 基础上|加快 建立$国土 资源|信息 交换 体系
带动 调查|评价 工作 流程的 重组$和|传统 工作 方式的 变革
形成 统一的|国土 资源 信息化|技术 标准 体系
积极 为|国土 资源|信息化 建设$提供|可靠 经费 保障
线路 全长|十八点九六 公里
是 我国|八五 九五 期间|开发的|最大的 磷肥 项目
外交部 发言人|章启月|今天 在|此间 宣布
湖北 省委 书记|俞正声|理直 气壮地 指出
不过 在|最近的 两届 比赛上
广东队|三号 李毅|门前 趁乱 起脚
既能 培养 员工|自觉 健身的 意识
主场 作战的 球队|表现|并不 尽如 人意
六月 九日|客场|以 三比一|击败 新浪狮队
本赛季|已经 取得了|七连胜
目前 排名 第二的|山东 金斯顿队|做客 广东
山东队 凭借|最后 一节的|双外援 战术
深圳队 外援 卡塔默$和 江苏队 队员|丁铁|在 场上|发生 冲突
武术 运动|由|套路 和 散手|两大 体系 组成
长期 坐在 电脑前$或者 处于|暖气 环境下
轿车 生产$还是 占其|相当大的 比重
菲亚特的|库存 时间|却是 一百天
关闭的 工厂|大部分 在海外
欧元 替代 欧元区国|现有 货币$将|不会 出现 难以|克服的 问题
欧元区国的 居民$的确 需要 时间$来 适应 新的|统一 货币
将使 他们|对|自己 作为 欧洲人|所发挥的 作用$有新的 认识
将 推动|欧洲 大陆$在 联合的 过程中|保持|和平 与 繁荣
上海 哈瓦那 农场|在 古巴$广为 流传
在 古巴|从|国外 引进的|十个 项目中
目前 农场 建有|十个 独立 大棚$和|二十座 连体 大棚
从 今年|三月起 至今$已 收获了|二十吨 各类 蔬菜
一九九八年$他率|古中 友协 代表团$访问 上海 时
却|出色地 解决了|人们的 吃菜 问题
在 古巴|仅 哈瓦那市 周围$就有 不下|十万 公顷的 耕地
由 上海 市领导|率领的|中共 代表团$访问了 古巴
望着 一排排|宽敞 整齐的|蔬菜 连体 大棚
公安 干警|人手 一本|警务 公开 手册
把 人民|是否 满意的|评判权$交给 群众
确保了|选人 用人的|准确性$和 可靠性
在 自己的|入党 申请书上$画上了 一个|撼人 心魄的 惊叹号
陈涛|生前 所在的 中队$驻在 山西省|繁峙县|横涧乡|东淤地村
乘警长 刘应昆|巡查到|陈涛 所在 车厢时
便把 杜文军|交给|陈涛 临时 看管
杜文军|捂着 肚子|要求 上厕所
陈涛|紧紧 拽住|杜文军的 后衣领
随即 拔出|隐藏在 腰间的|弹簧刀
锋利的 尖刀|深深地 扎进了 他的 左臂$后经 法医 鉴定
犯罪 嫌疑人|杜文军|乘机 跳车 逃窜
尖刀|几乎 带柄|扎进了 陈涛的 胸部
当 战友们|把 陈涛|送到 医院
陈涛|在 人们的 麻木|和 冷漠中$永远|闭上了 双眼
是|三个 代表|重要 思想的 哺育
铸就了 他|永远做|党 和 人民的|忠诚 卫士的$高尚 品格
他用 行动|践行了 自己的|入党 誓言
陈涛的 父亲|陈清贵$庄重地 捧着 一万元钱
是|全国 有名的|特困县 之一
积极 稳妥地 实行了|县直 机构 改革
不准 以 各种 名义$搞 相互 走访|等拜年 活动
她 今天|穿了 一件|肥肥 大大的 衣服
不准 下级 下属|企事业 单位|乘 节日 之机
严禁 赠送 和|接受 用|公款 支付的 礼金
湖北省 纪委|省 监察厅$派出 二十三个|巡视 督察组
对 送礼金|和 有价证券的 车辆
这个 大院|集 文化 教育$群众 娱乐$党团 之家 于一体
长期 以来|一直 用于 辽河|盘锦|本溪等 化肥厂
辽河 化肥厂|去年 亏损|达 十多万元
因 日用 天然气|三万 立方米的 要求$难以 解决|而 长期 拖延
荷兰|基思博斯 公司$欲 合资 兴建$单体 采暖 系统
辽宁的|天然气 资源|不算 丰富
辽宁|许多 领导 干部|有关 专家|和 人大代表 呼吁
对|亏损的 化肥厂|停止 供气
其 贡献|是 其他 所有制 经济$不可 替代的
集体 经济|所 提倡的$互助 合作 精神
一些 内容 已|不适应 当前|城镇 集体 企业 发展$和|发展的 状况
三$把 集体 企业|与 联社的 改制|结合 起来
在 项目 开发|制造 销售$服务 等环节|形成 产权 组合的 链
集中 联社 企业|经营者的 优势
这个|自 明清 以来|不断 萎缩的 湖泊
整治 后的 洞庭湖$如果 再遇到|二零零一年 那样的|特大 洪水
凶猛的 洪水$再也 爬不到$那 令人|毛骨 悚然的 高度
洪涝 灾害 造成的|直接 经济 损失$就达 十亿元
平垸 行洪|还洞庭|浩浩 荡荡
在 随后 进行的$中华|文化 学院|发展 基金|捐赠 仪式上
高亢 嘹亮的 牧歌$传递着 内蒙古|各族 人民|深情的 问候
刚健 豪放的 舞姿$展示着|千里 草原|欣欣 向荣的|时代 风貌
随着|紫红色的 帷幕|徐徐 拉开
那在|蓝天 碧野 大幕 映衬下的|草原 气息$便|扑面 而来
六个 身穿|鲜艳 民族 服饰的|姑娘$手捧|圣洁的 哈达
不时 让|观众 沉浸在 草原的$辽阔 壮美中
内蒙古|乌兰牧骑$是 活跃在|内蒙古 草原上的|文艺 轻骑兵
根据 中华人民共和国$缔结 条约|程序法的 规定
乌拉圭 和|突尼斯|五国 情况的|书面 报告
五国|对 李鹏 委员长的 访问$非常 重视
均 给予|热情 友好 隆重的 接待
为 进一步 发展|同|北非 拉美 国家|友好 合作 关系
全面 阐述了|我国对 当前|重大 国际 问题的 看法
中国 与 古巴|阿尔及利亚 和|突尼斯|建交 时间 早
希望|继续 保持|双边 高层 往来
中方 希望|增进 同|五国 议会的 交流
高度 赞赏|一国两制 方针$在 香港 澳门的|成功 实践
他们|赞同 李鹏 委员长$关于|加强 议会 交流
增进 人民 之间|友谊的 倡议
访问 阿尔及利亚$突尼斯$阿根廷 和|乌拉圭 期间
当面 向|卡斯特罗 主席|表示 慰问
这|充分 证明$中国 是 古巴$真正 可以|信赖的 朋友
卡斯特罗 主席$在 领导 抗灾的|百忙 之中
我 与 乌拉圭的 贸易$主要 集中在|羊毛 等|传统 商品 方面
双方 正在 探讨|进一步|扩大 贸易的 办法
我 与 突尼斯的|经贸 合作$已有 近百年的 历史
正值 我|经贸 代表团 到访$并 举办|商品 展览会
出现了|阿 各界 人士|踊跃 参观 我|商品展的 盛况
增强了|进一步 开拓$同|中国 经贸|合作的 信心
他们 也 表示$欢迎|更多的 中国 企业家 访问
阿尔及利亚$是|不结盟 运动|主要 创始国 之一
都在 认真 思考$本国 应对的|政策 和 措施
他 强调$中国 反对|霸权 主义$和 强权政治
中国 希望|阿富汗的 战争|早日 结束
让 阿富汗 人民|自主 决定$解决|本国 问题的|方式 和 方法
有利于|建立 一个|更加 均衡的$国际 社会
取消 贸易 壁垒$并 减轻|发展中 国家的 债务
反对 恐怖主义|是 会谈的|重要 议题 之一
有利于 我|全面 开拓 与|上述 地区|国家 关系的 新局面
应 努力 克服|世界 经济 趋缓的|消极 影响
但这|不妨碍 我们|取长 补短
记者 就此 专访了|乌 新任 驻华 大使$列兹尼克
江主席|对 乌的 这次 访问|意义 重大
为 新世纪|乌中 关系的 全面 发展$开辟了|广阔 前景
在向 记者 介绍|乌|国内 情况时
九七年 曾 作为|前苏联 专家|赴华 工作
盼望 有朝 一日|亲眼 看看|伟大的 中国
参观 游览$曾 留下|父亲 足迹的|那些|中国 名胜古迹
摧毁了 一个|重大 国际$贩毒 洗钱 集团
利用|哥|金融 系统|存在的 漏洞
为 这两个|著名 国际 贩毒 集团$至少 漂洗了|四千万 美元的 毒资
强烈 谴责|美国 近日 对|四名 古巴人$不公正的 判决
从事|间谍 活动$和 企图 实施|谋杀 为 罪名
逮捕了|在美 工作的|赫埃尔 南德斯等|三名 古巴人
会场 入口处$用 醒目的|五星红旗 装饰
他 作为 嘉宾$出席了|普京 在|克里姆林宫 举行的|新年 招待会
为了 最终 消除|冷战 结束 之后|出现的 小摩擦
并有 很好的 渠道$了解|国内外 局势
印 反对党|支持 政府$对巴 措施
美国 大使|布莱克维尔$昨天 约见了|印度 外长 辛格
中铁 十四局 承建的|贵州 六枝 境内$新倮纳 隧道
铁道部 决定$复线|绕开 城区
人们 称它为$中国 铁路|建设史 上的|吉尼斯 纪录
中铁 四局 施工的|翁塘特 大桥
施工 人员|立即 拆下|自己 立好的$第四节 模型|重新 整修
为了 提高|混凝土 搅拌 质量
他们 修建的|全部 工程$成为|贵州段|引路 样板
十七局的 职工$进入 工地|第一件事
然后 再建|取渣场|和 弃渣场
有一块|上坪 乡政府|立的 石碑
正在此 施工的|铁二局 建筑处$为 上坪乡$修建了|百米 防洪 大堤
进一步 暴露 其|反 人类$反 社会$反 科学的 本质
在|世界 经济 增长|明显 放缓的 情况下
高举|邓小平理论|伟大 旗帜
敬业 奉献|是 公民|基本 道德 规范
引导 农民|更多地 从事|非农 产业
建设 一批|有利于 农民|直接 增收的 项目
实行了 农工商|综合 经营$和|农业 产业化 经营
职工|自营 经济|异军 突起
为 职工 在|自家的 园子里|采摘 火龙果
在 转移|农村 剩余 劳动力|这一 问题上
如果 怪|上中滩|和|南堡寨 农民 懒惰
如果 让你|在街头|连呆 几天|找不到 活干
到头来$工钱 却被|扣得 精光
估计 现今|绝大多数 干部$都可以 答出个|子丑 寅卯
而是|千方 百计|从 农民 手中|捞取 好处
记者 崔士鑫$温红彦$董洪亮 报道
掌握 马克思主义的|立场|观点|方法
要|不断 改善|广大 师生的$工作 学习|和 生活 条件
协助 银行|做好|国家 贴息|助学 贷款 工作
确保 每一个 学生$不因|家庭 经济 困难|而 辍学
继续 坚持|和 完善|党委 领导下的|校长 负责制
保持|共产党人的|高尚 情操 和|革命 气节
并|结合 实际|抓好|贯彻 落实
通过|技术 改造 和|改善 经营 管理|双管 齐下
邯钢人|奋力 拼搏的 作风$真诚 奉献的 精神
为 加强|中越 两国 人民|传统 友谊$作出了 贡献
二零零三年|炼铁 炼钢 能力$就由 十万吨|和 十五万吨
越南 政府 为我|援越 太空|技改 项目$举行了 隆重的|竣工 典礼
但是|后来 由于|技术 设备 和|管理 更新 缓慢等 原因
一边 帮助|太钢 工作 人员|掌握|和 熟悉 工艺 参数$和 设备 性能
一年 一度的|元旦 戏曲 晚会$自 九八年|编创 录制|播出 以来
联手 阵容|也 扩大到|十个 省市 电视台
地方 特色 鲜明|而又|浑然 一体
又有|新意 迭出的|戏歌 京剧 大歌舞|和|京剧 交响乐
生动地 展现了|中国 戏曲的|时代 风采
中共中央|政治局 委员$北京 市委 书记|贾庆林
株六 铁路 复线|东起 湖南省 株洲市
其中$三种 矿产 储量|居|全国 前三位
穿越 乌蒙山区等|高山 峡谷
株六 铁路 复线$是 联系|西南 和|中南 华东的 纽带
铁道部 部长|傅志寰$副部长 蔡庆华
增速|高于 年初 确定的$预期 目标
六月份|规模 以上 工业 企业|实现 利润 七亿元
城乡 居民 收入|增长|有所 加快
和 首都|各界 人士 一起$观看 演出
以|行云流水 般的 演唱$和 精彩的|武工 技艺$赢得了|满堂 喝彩
以其|稚嫩 而又|颇有 韵味的 演唱
再现了|前辈 艺术家 创造的|一曲曲|精彩 唱段
晚会 在|新创作的|京剧 联唱$世纪 之春的|激越 旋律中 结束
江泽民$李瑞环$胡锦涛$尉健行$李岚清|走上 舞台
小说$散文$诗歌$影视 文学等|均有 涉猎
中国 京剧史|全书|三卷 四 册
观众 还能 一睹|宁静 饰演 穆桂英的$飒爽 英姿
同样 发生在|居民楼里的 故事|鞋之错$让人|哭笑 不得
没想到$从|邻居家 借来的 一双|旧鞋$引起了|不小的 误会
石头村的 孩子$终于 拥有了|属于 自己的|温暖 校舍
元旦 期间 播出的|外国 影片 还有$法国的 警察
好莱坞|经典 影片$索菲的 抉择$和|尽善 尽美
在 电影 史上|都有|一席 之地
国人 莫不 感到|时代 前进$如奔 如 飞
而 某些|文化 艺术 观念|相对 滞后
王汶石 笔下的|张腊月$吴淑兰$相提 并论
何况|白景琦 这位 爷$具有|爱国 气节
而|作品 分明 表现出$对|逝去 旧梦的|欣赏 与 怀恋
这就是 为|观众 塑造的|英雄 形象
对待 妇女的 观念$是 一个 社会|文明 程度的 标志
有人 拿|这个戏$与 红楼梦|相提 并论
你 看到的$不是 主子|就是 奴才
历史上|虽 不乏|有所 作为的 皇帝
但 皇帝 毕竟是|宗法|封建 制度的 产物
影视 中的|皇帝戏 却|左一部
能给 我们 带来|什么样的|文化 观念
不仅 是指|表现|封建 社会 生活时$缺乏|批判 眼光
两位 作家|入围|鲁迅 文学奖$散文 杂文奖
一批 实力派 作家$都有|力作 行世
季羡林|曾有 一篇|著名的|虎年 抒怀$让人 感慨 万分
沈园 柳老 不飞绵|是其 代表
作者 为一|普通的 女子|涌热血 洒热泪
透出 一个|正直 文人的$坦荡 胸怀
感动 文坛的|一篇 散文是$阎纲的$我吻 女儿的 前额
幻化出 一个|让人感$让人痛$让人思的 生命
白发人 送|黑发人的|苦难 心肠
长期 生活在|伏牛山 一隅$对|乡村 怀有 深情的|周同宾
以 深刻的 笔触$描绘出了 一幅|年前的 惨景
从 将月亮|放置在 门外的|城市 望开去
望到 夜的|纯洁的 黑$神秘的 黑$深刻的 黑
对这 黑的 描写$覆上了 安详|仁慈|与 温馨
其在|长期的 旅行 当中$不断地 写出 关于|自然 与 生命的 散文
展现出 作者|细微|而 带有|质感的 心灵
而这|正是 我们 生活中|所应|相拥 相爱的
而 唐兴顺|和 谢宗玉$也 以其|厚实的 作品|入列 其中
及|对待 这些|事物的 观点$都有 自己$独特的 层面
以 他们|更新的 视角|及|创作 方式
但 什么 事情|都怕|趋之 若鹜
这类 所谓|厚重的 文化|散文的 堆积$让 读者 感到|些许 无奈
应当|重新 提倡|精短 散文的 写作
在|重要 前沿 领域|硕果 尤显
这个 突破|极有 可能$为 未来的|分子 计算机 开发|铺平 道路
都有 相关|配套|科技 政策的 支撑
布什 政府|更加 强调了$基础 科学|和 军事 研究
一些 比较 发达的 小国$学习 近年|异军 突起的|西北欧 诸国
国际 人力 资源的|争夺战$主要 围绕|优秀|科技 人才 进行
日本|重在 提高|本国 科技 人员的|创造 精神$和 冒险 精神
新加坡 实施|外资 和 外才|引进 并举的 政策
促进 研究 人员$在 欧盟区 内的|虚拟|和 实质 流动
而|遏制 他们 向|北美的 外流
竞争 热点 领域$则是|信息 通信 技术$生命 科学$和 纳米 技术
在 世纪 上半叶|仍 将起|主导 作用
在 全世界|出现了 纳米热|和 纳米 大竞赛
纳米 技术 投入$占 欧盟|公共 资助 经费 总额的
加拿大 英国 等国的 政府$也发表 有关的|政策 文件
这也 促使$可持续 发展|成为 今年的|一个 热点
宣传|儿童 权利 公约的|具体 内容
是 衡量$领导 作风|端正 与否的|重要 标准
而 院领导的|公务 用车|是 桑塔纳
福建省|福州市 晋安区|新店镇 农民|敲起 腰鼓
采取|综合 措施|解决|人口 问题
对于 加快 我国|人口 与 计划 生育|法制 建设
这种 环保型|可生物 降解 产品
并 生产出|美丽门 系列$健康漆 及|防火 阻燃 装修漆
石家庄市 地税局$共 征收|个人 所得税|四点一 亿元
占|全市|个人 所得税 收入的|四分之一
周口市$把 优化 和|治理 经济 环境$放在|重中 之重的 位置 来抓
首批 五个|职能 部门$实行 集中 办公|一条龙 服务
二$外国 银行 在|中国 境内的 分行$以下 简称|外国 银行 分行
不得 损害$中华人民共和国的|社会 公共 利益
三$拟设 独资 银行|或者|独资 财务 公司的 章程
三$法定 验资 机构|出具的|验资 证明
其 总行|对|该 分行 承担|税务 债务的$责任 担保书
四$买卖 政府 债券|金融 债券
买卖 股票 以外的$其他 外币|有价 证券
外资 金融 机构的|存款 贷款 利率$及|各种 手续 费率
但是 经|中国人民银行|批准的 除外
外资 金融 机构$应当 确保 其|资产的 流动性
流动性 资产 余额$与 流动性|负债 余额的 比例$不得 低于
外资 金融 机构|有|下列 情况 之一的
并 依法 向|工商 行政 管理 机关$办理|有关 登记
五$变更 持有 资本 总额$或者|股份 总额 以上的 股东
经|中国人民银行|审查 批准后$予以 解散$并 进行 清算
外资 金融 机构$因 解散|依法 被 撤销$或者 宣告|破产 而 终止的
并处|违法 所得|三倍 以上$五倍 以下的 罚款
依照 刑法 关于|非法 经营罪$或者|其他罪的 规定
向|家庭 困难的 村民$捐送|七千 八百 余件|过冬 衣被
何鲁丽$成思危$许嘉璐$蒋正华$万国权$周铁农$王文元 出席
并|畅谈了 在|谈判 过程中的 体会
向|国际 通行 规则|靠拢的 历史
一$任命 王振川 为|最高 人民检察院|检察 委员会 委员
过一个|欢乐 祥和|喜庆的 节日
要 大力 提倡$文明 健康 节俭的|社会主义 新风尚
四十五岁的 汪光焘$今天 被 任命为|建设部 部长
远高于 去年|三亿 美元的 水平
比|去年 起的|最高 水平|有所 减少
但 仍给|受灾 国家 和 地区$造成了|十亿 美元的 损失
纳粹 劳工 赔偿 基金$已 完成了|大部分 赔偿 申请的|受理 工作
最后的|截止 期限 为$本月 三十日
联合国 曾|多次 希望 海克鲁普$能|续签 工作 合同
这为|今后 两国 关系的 发展$指明了 方向
尽管|突发 事件|对 两国 关系$具有 重要 影响
对 人类的|前途 与 命运$负有|共同 责任
搞好 中美 关系$是 两国 人民的|共同 愿望
也是|两国 人民的$切身 利益 之所在
钱其琛 副总理$唐家璇外长$分别 于|三月 和|六月 访美
以 建设性|前瞻性的 态度$来 处理|中美 关系
有利于|推动 中美 关系|健康 稳定地 发展
请你 谈谈|中美 关系 中的|台湾 问题
扫除了|中美 经贸 关系中的$一大|人为 政治|干扰 因素
吸收|更多 美国的|投资 和 技术
推动 两国 关系$朝着 更加|积极的 方向 前进
新华社 华盛顿|四月 三日电|记者 胡晓明$美国 总统|布什|昨日 表示
尽管 美国 目前|还 不知道|本拉登的 下落
但 美国 军方$一定会 把他|逮捕 归案$并|绳之 以法
尽管 有 报道说$他把 头发|染成了 红色
美国 部队 将|继续|呆在 阿富汗
目前 尚未 就|军事 法庭的|审判 程序$作出 决定
四国 领导人|积极 评价$政治 解决|阿富汗 问题的|良好 开端
四国 总统|强烈 谴责$袭击 印度 议会的|恐怖 事件
我们 永远 不会|首先 发起 战争
布什 当天 在|得克萨斯州|克劳福德 私人 农场$对 记者 表示
在 印度 和|巴基斯坦|边境 城市 瓦格赫的|过境 通道
辽宁省 盘锦市$结合 本地 实际
盘锦 市委|市政府 主要 领导$专门 写信 给|各部门 各单位
加强|发行 市场 管理|整顿 发行 秩序
市委 宣传部|和 邮政局$随时 关注|党报 党刊|征订 进度
对|重点 生态|破坏 地区$实行|封育 围栏|退耕 还林 还草等 措施
客运 改革 试点|进一步|完善 扩大
今年 铁路 运输|主要 指标$创下 历史|最好 水平
江苏省 南京市|近千 市民$洒泪 送别|勇斗 歹徒的 英雄$周光裕
突然 听到|一个|中年 妇女 高喊
跑在 前面 的 歹徒|拎着刀|回过 头来
又 对他的|臀部|后背|颈部|胸部|连刺 五六刀
最后|朝|左锁骨|狠狠 刺了 一刀
这一刀$穿透了|周光裕的 肺部
对他|勇斗 歹徒的 壮举$并不 感到 突然
听见 老周 爱人|在|屋内 小声说
作案 凶器 从|玄武湖中 捞起
钨钼 材料厂|是个 停产的|特困 企业
金鼎成 公司 董事长|韩汇山$及|员工 代表|来到 周家
三月 四日$在 南京 火车站|被偷的 那名|中年 妇女$是 六合县人
六合县委 副书记|徐立堂$也 来到 周家
代表|县委 县政府$送上了|三千元 慰问金
向|周光裕家 表示|悼念|和 慰问的
他 还劝|王福琴 大姐|振作 起来
您 怎么|还不 回来$骨灰 安葬 仪式上
雨花台|烈士 陵园|管理局 局长|徐敦龙 说
周光裕 作为|新时代|见义 勇为的 英烈
江苏 省委书记|回良玉$在|周光裕|事迹 材料上 写道
周光裕的|高尚 品格|值得|赞美 和 学习
周叔叔 用他的|热血 和 生命
往往 限于$拿出 手机|报个警
周师傅 比我 勇敢|何止 十倍
平时 在|公交车上 也|看到过 小偷 行窃
而这 正是|平凡|与 伟大的 距离
还要 敢于|同|坏人 坏事|作 斗争
京珠 国道 主干线$耒阳 至 宜章|高速 公路 竣工 通车
一$有利于|扩大 消费者的|知情权 和|决策 参与权
铁路 票价$关乎 老百姓的|切身 利益
调整 价格$先 听听|消费者的 意见
可|防止 铁路 部门|利用 垄断 地位$谋取|不正当的|部门利益
党中央|国务院$高度 重视|三峡 库区的|地质 灾害 管理
黑龙江省 鹤岗市$就是|这样 一座 城市
大区域 经济的 发展$才会 带来|鹤岗市的 繁荣
鹤岗市 地处|三江 平原 腹地
市里 共 安排了|矿务局的|三十名 职工 进市场
这使得|鹤岗市的|财政 状况$发生了 很大的 改观
大手笔|扶贫 解困$才能 带来|鹤岗市|长久的 稳定
他们 又 实施$道路 延长|拓宽 工程|街区 亮化 工程
他们 在 市区|移栽了 一百棵$有|三十年 树龄的 红松
鹤岗的 老百姓|生活 水平$也有了|很大 改善
但是|依然 存在着 一些|困难 群体
鹤岗市|又 倡导|万户 大对接
为了|帮教|法轮功 练习者 转化
每年|森林 采伐量$就达|十万 平方米
他们 还|开矿|修路|建厂|办 超市等
首都|贺岁 节目|又多 又 精彩
首都|舞台 演出 活动|丰富 多彩
十月 一日|至|明年 三月 一日$将在 北京|中国 革命 博物馆 举行
在|全球 经济 增长|明显 减缓的 情况下
在 世界|很不 安宁的 情况下
必须|进一步 端正|对待 马克思主义的 态度
要|大力 弘扬|理论 联系 实际$学以 致用的 学风
尤其要 注意$对|干部|思想 政治 素质的 考察
努力 提高|马克思主义 理论 水平$和|思想 修养 水平
不断 增强|为 人民 服务的 本领
各地 在|换届中$要 严格按 党的|政策 和|规矩 办事
进一步 密切|党群 干群 关系
围绕 迎接|党的 十六大 召开$扎扎 实实地 做好|明年的 工作
强调 要|围绕 十六大的|组织 准备$和|部分 省区|市党委 换届
同时$也 使我们 面临|严峻的 挑战
我们 要|抓紧 学习$和 掌握|世贸 组织的|有关 规则
按照 法制|统一 原则$非 歧视 原则$和|公开 透明 原则
杨景宇 主要 讲了|以下|几个 方面的 内容
去年的|阪神 大地震$使 神户的 经济$遭到了 严重 破坏
神户市|企画 调整局的|三木孝$对 记者说
十三亿 人口中|已有 十亿$是 六十岁|以上的 老人
在 这里|兴建 医疗|高科技 园区$有着|得天 独厚的 优势
医疗 机器 开发|药品 临床 研究$和|再生 医疗的|临床 应用
神户 医疗 产业城的|运营$采取|官民 并举的 方针
就|参赛 作品的|创意|字体|结构|字形|规范等 方面|进行 评分
他 收到了|学生 送来的|一张 贺卡
在 该校 学生|环保 社团|山诺会$不大的 活动室里
上面 用|彩色 水笔$一丝 不苟地|描画出|美丽的 图案
粗糙的 再生纸|变成了|精致的 贺卡
围着 一大群|笑脸 盈盈的 大学生
一万张|新年 贺卡|等于$多少 木材
又创|连作 晚稻|亩产 新纪录
该组合 集|高产 优质 多抗$及|优良 株型 于一体
今天|在京 通过|科技部 组织的|专家 论证
以$符合受 教育者|特征的|适当 方式
有 计划地 开展|生理 卫生 教育$青春期 教育$或者|性健康 教育
禁止 歧视 虐待|生育 女婴的 妇女$和|不育的 妇女
有 条件的 地方|可以 根据|政府$引导 农民|自愿的 原则
可以 获得|延长 婚假$生育 假的 奖励$或者|其他 福利 待遇
独生 子女|发生 意外|伤残 死亡
国家 建立|婚前 保健$孕产期 保健 制度
对 已婚|育龄 妇女$开展|孕情 检查|随访 服务 工作
处|违法 所得$两倍 以上|六倍 以下的 罚款
处|五千元 以上$两万元 以下的 罚款
计划 生育|技术 服务 人员|违章 操作$或者|延误 抢救 诊治
依照 有关 法律|行政 法规的 规定$承担|相应的 法律 责任
二$滥用 职权|玩忽 职守|徇私 舞弊的
中国人民解放军|执行 本法的|具体 办法
可 均匀地 涂在$玻璃$金属$木板$纸张$陶瓷等 物品上
对|个体 私营 企业 注册$快 受理$快 勘察$快 审批$快 发 照
这种 室内|装饰 装修 材料|有害 物质 限量的$国家 标准 包括
为 加强$对|室内 装饰 装修 材料|污染的 控制
而且|这两条 河流|泥沙 测验 工作|开展得 较早
再 扩展到|全国|各 主要 河流
用|党风 廉政 建设$和|反腐败 斗争的 成果|取信 于民
参加|党风 党纪|教育 竞赛的 党员$有 数万名
对 六名|拟 提拔的|领导 干部$进行了 任前 公示
安阳市委 书记|方晓宇 认为
市委 对|党风 廉政 建设$和|反腐败 工作|严格 制度
收到|全国 各地|通讯员 来稿|一百 余件
肖晓良 拍摄的|相伴 红船 等作品$获 二等奖
全国 人民 代表大会|常务 委员会|任免 名单
盗窃 抢夺|枪支 弹药 爆炸物的
或者|盗窃 抢夺$毒害性|放射性$传染病 病原体 等物质
并处|洗钱 数额|百分之五 以上$百分之二十 以下 罚金
二$协助 将|财产 转换为 现金|或者 金融 票据的
因 营养 不良|和|缺医 少药|而 死亡的 人数$不断 上升
它们 将与 此前|已在 轨道 飞行的$三颗 信使 卫星|形成 一个 整体
法轮功 组织$在 加拿大|大肆 宣扬|歪理 邪说
特别 对 持|不同 意见的 媒体$进行 骚扰$威胁 和 围攻
自从|本月 三十日$印度 议会 大厦|遭到 恐怖 袭击
虽然 美国 等国|进行了 调停
并 将其|外交 官员的|活动 范围$限制在|伊斯兰堡 市内
从明年 七月 一日起$禁止 印度 飞机|飞越 巴基斯坦 领空
同时$巴驻印 外交 使团的|外交 人员|也必须 减半
在于 它 有着|更为 复杂的 背景
巴军方 有能力 维护|国家的 尊严|和 领土 完整
使得 两国间 气氛|更加 严峻|和 紧张
而 军事 手段$是|彼此 施压 缓 压的|一个 杠杆
并 以此 捞取|政治上 和|经济上的 好处
导致 局面|失控的 因素$也|不可 避免地 增多
早在 去年 七月$北京|中非 合作 论坛|会议 期间
但在|今年 四月|卢萨卡 中非$部长级 磋商 会议上
埃塞 与 中国|长期 以来$一直 保持着|亲密 友好的 合作 关系
呼吁 双方|立即 冷静地 作出|一切 必要 努力
并且 通过|和平 方式$解决|当前 危机
代表|同心 昌盛$吉祥 吉庆 有余的|中国 结
表达|对 祖国的|祝福$和 对|美好 生活的 向往
与时 俱进|扎实 推进 国防|后备 力量 建设
体现了 一个 企业家$不改 石心|性自华的|诗情 和 胸襟
蒙面 之城|写 出了 人类|和 文化的|自由 向往
探讨|广东 文艺 创作的|重要 走向
广东 作家|自觉地 用|手中的 笔$反映|三十年|沧桑 巨变的 时代 风貌
林雨纯 和|郭洪义 两位 作者$在 深圳 南岭村|挂职 生活
广东 文艺 创作$以 敏锐的 眼光$深刻 认识|和 反映 现实 生活
敏锐地|捕捉到 这一|非常 事件
在 众多|抗洪 救灾 题材的$报告 文学 作品中$独标 一帜
前夜的 涌动$得到|与会者的 赞誉
而且 蕴藏着|整个 世纪|文化 发展的 机锋
从中 我们 看到了|生命的 烙印$现实的 侧影$和 时代的 潜流
作者 以 俄国 作家|涅克拉索夫 的话$作为 自己|创作的 警示
它|既 不同于 史学家的|考古 求实
也 不同于|哲学家的|离象 求真
升华了|曾经 存在的|悲伤 和 怨 情
我们 可以 感受到$中国|特定 历史 时代的 气息
我们 可以 从|一系列$不断 出现的|经典 著作 引文|和 思考中
整部 小说|连绵 不断的|文字 背后
实际上 是|节奏 顿挫的|诗行 诗句
但|火热 充沛的 诗情$又 使得 我们|不断 原谅 这种|诗意的 赤诚
时代 大坝上|那 微微的 颤动
而 恰恰那|风雷 激荡的 年代
生活中 缺乏 抒写的$正是 这种|纯洁的 激情|和 坦荡的 豪迈
而对|壮烈 坚硬 确凿$从不 涂改的 现实$历史的|第二次 书写
建立 健全|维护 社会 稳定的|有效 机制
下决心 整顿|和 改进|市场 经济 秩序
造成了 水质型|水资源 短缺
进一步|重视 和 抓好|水污染 防治$和 水资源 保护 工作
为 长江 流域的|可持续 发展$创造 良好的 环境
使|执法 监督 取得|更大的 实效
南湖区|现代 园林化 城区$已现 雏形
新改造的|火车站 广场|漂亮 壮观
南宁市|以 构筑 大西南|出海 通道|枢纽 城市 为目标
悄然 来到 这里|检查|运行 落实 情况
并 逐步 实行|服务 承诺$首问 责任$限时 办结 等制度
并由 相关 部门|接受 和 处理|日常 举报|投诉 事宜
一位 巨人|静悄悄地|驻足在 这里
几缕 云霞$几缕 青烟$随 山峦|渐渐 弥尽
这样的 土地|注定 每一寸|都是 民间的
虔诚的 目光$聚焦成 一块|散发着 神秘 气息的 道场
他们的 思想$如 一匹|佛化的 神骏
他们的 眼睛$平和地|注视着 苍崖
使 他们 闻到了|比|香火 更浓的 东西
一股 靡靡 之音$正 拍打着 那里的|细柳 和 芭蕉
他们 渴望 在|石头里 涅槃 永生
他们 都想|镌刻在 面前的 山崖上
在|二十 世纪末$这个|烟雨 濛濛的 日子里
我们 很 偶然地|站立在 这片 山崖
或许 这是|马蹄湾|给她的 神示
绝没有 柳赵 二僧|那么|痴妄 和 专注
读出的$却是 一脸的|幸福 与 自豪
他们|坚不 可摧的 思想$体现在 摩崖 石像上
必须 像 许多的|高僧 大德 一样
把 自己|对 佛的 参悟|和 理解$弘扬 于 世
他们 将|劝人 为善的 故事$发挥到|一种 极致
或|惊惶 失措|跪地 而眠$从 未牧|到 双忘的$修证 成佛
很 类似于|禅宗 渐修的 公案
柳赵 二僧$把佛 融会于|乡村 朴素的|劳动 之中
把 人生的 痛苦$转化 为一种|平民 智慧
柳本尊|和 赵智风 追求的|却是 一种 世俗化
他们|都会是 一位|乡村的 贤者
娓娓地 向你 叙述着|向善的 愿望$佛的 平易
濛濛 细雨|挟裹着|历史的 烟云
裸裎着 那只$古老 而|沉重的 大足
冰峪|大约 只能在|冬日里 相思
当我 写下|相约 冰峪|四个 字时
但 背阴处|仍 留下了|浅 且白的|一层 痕迹
照|字面的 理解 是$冰的 山谷
我是 在一个|盛夏的 夜晚|走进 冰峪的
山路 亦是|忽平 忽仄|起伏 不定
前方|居然 有一块|平坦的 停车场
此处|泊车的 地方$属于|旱地 忽律|朱贵 先生
我 甚至 看见|匠心 独运的 主人$沿|山脊 拉出的|一串 彩灯
有一处 叫|中流 砥柱的 峭岩
有|丝毫 不逊于|桂林的 山峰
急切里 想去|亲近这|山区的 精灵
只为|照一下 自己|翩翩的 倩影吧
此庙 也|因而 定名|护国 随粮 王庙
老百姓 就把|香火 蜡烛$插在 庙门外的|地上烧
护国 随粮 王庙$又在 原址上|修复 一新
一面 端详着|清官 模样的 神像
作为|江南 水乡 文化的|一个 标本
西塘 古镇$依然 保持着|明清时的 旧貌
镇上 即便|某家 店铺 歇业|或 搬迁
也不会 将|门外的 廊棚 拆除
老板 看|屋檐 太窄|遮不了 风雨
店主 猜想$这位 叫化子|可能 是位 仙人
街上 现存|最 宏伟的 民宅$叫 种福堂
是 当时|大户 人家|王有贞的 宅第
此宅 前后|七埭 层次 或 单元
两边 都 是|金 漆雕 花 落地长 窗
每逢 雨天$行人 不小心|就会 滑倒|掉入 河里
当|岁月的 脚步|快要 跨出|年的 门槛
面对 这种|近乎|残酷的 事实
即使 是|最 乐观的 人们$也|不得不|发出 感叹
到|新浪的 创始人|王志东$都 不能 幸免时
甚至 有 许多人|希望 以 民意$改变 新浪|董事会的 决定
新 经济的|倡导者们|要在|严冬中 幸存
新浪的|幕后 指挥者|高在朗$甚至在|公司 内部|提出 一个 口号
但 人们 对|宽带 互联网的 前景$充满 信心
著名 未来 学家$第三次 浪潮的 作者|阿尔文 托夫勒|应邀 与会
阐述了|自己 对|宽带的 见解
宽带 是|第三次 信息 浪潮的|基础 设施的$重要 组成 部分
是 第三次|浪潮 经济的 中心
催生了|宽带 互联网|迅猛 崛起
八纵 八横|光纤网的 建设$和|中国 网通|宽带 骨干网的 开通
标志着|骨干网的 宽带 问题$已|基本 解决
拆分 前的 中国电信$就已在 全国|各 主要 区域$拉开 架式
准备 携|铜轴 有线网|进军 城域网
这是 一个|与$世界 高速 计算机 网络|相 接轨的|研究 环境
与 网络 产品$在 全球 范围内的|疲软 相比
去年|国内 网络 市场|称得上|风景 这边 独好
连|二次 创业的 王志东|新创办的$点击 科技 公司
西部 边陲 城市|喀什的|丝路 明珠 网吧
但 那份 热闹|属于|虚拟 空间
公关 公司|是 这个 领域|最 灵敏的 晴雨表
国产 个人 电脑|两位 少帅的|坦率 言论$有力地|印证了 这一点
向|媒体 发布了|所在 公司的|坏 消息
作为 用户的 甲方|所 秉持的 态度$正|逐渐 成为|市场的 主导
从 微软|英特尔 联盟|成立 以来
这种 局面|正 发生着 某种|微妙的 变化
尽管 迄今 为止$最终的|统计 结果|还没有 出来
曾经|叱咤 风云的 乙方$如今|度日 如年
市场 策划者$在 有限的 空间里$辗转 腾挪
各种|新口号 新提法|没完 没了
一位 用户|在 网上的 帖子$成了|声讨|换心 笔记本 电脑的 檄文
我们的 失误 在于|没有 向消费者|详尽地 介绍
那些 标榜|绝对 不用|台式机 芯片的 厂商$马上 就会|改变 主意
与|换心 事件|同样 引起 争议的$是|爱普生 打印机的|墨盒 残留
这些 墨盒|往往 在 还剩下|很多 墨水的 情况下$就 停止 工作
说着 便|匆匆|停止了 这款 产品的 销售
要|结束 这些|没完 没了的|是是 非非
责令 盗版者|高术 公司$向 方正 电子|赔偿 损失|一百 余万元
反盗版的 序幕$只不过|刚刚 拉开
中芯 公司|多思 科技园$中科院 计算所$纷纷 宣布|制成 中国芯
把 整个|芯片 领域$烘托得|红红 火火
在|冰冷的 海水|与|炽热的 火焰 之间
中国的|计算机 产业$与 春天 有个 约会$不见 不散
团中央 直属机关|英语 我 能讲|活动 展开
是 坚持|还是 否定|一个 中国的 原则
对 台湾 同胞|感情|和 意愿的 尊重
大陆|不会 收取 台湾|一分 一厘的 税收
不会|调取 台湾|一分 一厘的 资金
是否|明确 接受|一个 中国 原则
制造了|种种 两岸 关系|缓和 稳定的 假象
使得|台湾 海峡 局势|持续 紧张$政治 僵局 依旧
台湾 地区|举行了 立委|和|县市长 选举
也是 我们|对台 政策的 底线
在|短短的 几个月内$就使 安泰|即热式 热水器$俏销 市场
金蝶|国际 软件 集团|今天 宣布
华北 东部$东北 大部$黄淮 江淮$有 三级 偏北风
广东省 惠州市|大亚湾|经济 技术 开发区$经年|艰苦 创业
十亿 美元|不含|中海 壳牌 项目
宁波 市委 书记|黄兴国$率先 站在|市政协 宾馆的 讲台上
对|亲属 和|身边 工作 人员|约法 三章
公务中 收到的|礼金 礼券 礼品|价值|一万 余元
浙江省|党政 领导|落实 抓|一个县
孙中山 纪念馆|每天 吸引 大批|中外 游客$前来 参观
全面 提高|法院 队伍$总体 素质的 路子
实力 处于 下风的|国安队|凶多 吉少
国安 队员 杨璞|做出|有力的 回应
主场 输了$反而 为 我们|卸去了 包袱
这说明 我们 实力$并不比 他们|差多少
人群中|喜悦 兴奋的 情绪$顿时|蔓延 开来
他 知道$马上 要 面对|蜂拥 而至的|采访 祝贺
立刻 把脸|深深 埋在|一大块 毛巾里
似乎|每个人 都知道$该 把这|短暂的 瞬间|留给 黄金宝
当 问及|已经 三十岁的 黄金宝$是否 考虑过|退役 时
并 帮助他|拿了 两块|全运会 金牌的|沈金康 教练说
而|香港 运动员|退役后$又 未必有|好的 就业 选择
他的 力量|到底 源于 哪里呢
泰国 政府$正 酝酿 成立|专门 管理 机构
街头 发廊|成为 人们|剪发 修须的 好去处
七月 中旬$甚至|跌破 每桶 一美元
图为 二十三日$在|克什米尔|实际 控制线|巴方 一侧的|碉堡 中
印度 和|巴基斯坦的 关系$日趋 紧张
萨阿 总统|是 今天 下午$在 总统府 会见|各国 驻阿 外交 使节时
去年|他曾 参加|阿根廷 省长 代表团$访问 北京
在 阿根廷的|华侨 华人$蒙受了|巨大的 损失
浙江省|原有|公开 出版的 报纸|一百种$期刊|一百 五十种
来华 团体|旅游 签证$可到|授权 口岸 办理
在华 停留 时间$最长|不超过 三个月
这|并不 意味着|国家|对 煤价|撒手 不管
为 维持|煤炭 市场 秩序$保证 国民 经济的|正常 运行
一些 大国 和|国际 组织$在|日元 贬值 问题上|达成了|某种 默契
将 针对|日本 政府|纵容|甚至|刻意 引导 日元 贬值$采取 对策
日本 官方的|不少 言行$实际 都是 在|诱导 日元 贬值
尽管 该 体系|由于 轴心国 美国|经济 实力 下降
一些 发展中 国家$和|发达 国家|货币的|竞相 贬值
就|曾经是 亚洲|新一轮|货币 动荡的|导火索
酿成了|国内 经济|金融 危机
有的 经济学家$甚至|悲观地 感慨
现在 是 应该|重温|年代 萧条|经济学的 时候了
为 世界 经济的|尽早 复苏$打开了 一个|时间 窗口
在|某些 国家 和|组织的 默许下
本身 也是|舍本 求末$缘木 求鱼
对 贬值|刺激 出口的 作用$也不能 期望 过高
并 在此 当中|承担起 责任|和 义务来
天津的|国有 企业$经历了 一次|思想 教育$和|思想 解放的 洗礼
三讲|学习 教育 活动|要 搞好
市委 书记|张立昌$就 反复 强调
找出了 企业中|对 三讲 存在的|三种 模糊 认识
三是 担心|搞 三讲|会 引发 矛盾
从而 使|开展 学教 活动的|企业 总数$达到 三个
被 称作|真为 国企|拉套的 人
建立了 商贸|粮食 仓储$面粉 加工|三大 基地
极大地|调动了 职工的|工作 热情
大型 商业 企业|劝业 华联 集团|组建后
集团 党委书记|唐吉霞$高兴地 告诉 记者
三讲|使 企业|人心 齐了$思路 明了$班子 作风 实了
天津 地毯 进出口 公司的|退休 党员|王亚增$激动 难抑
他在 写给|指导 检查组的 一封信中|动情 地说
从未像 现在 这样|精悍 有力$我 盼望着|地毯 公司$再创 辉煌
新风 唤春归$广东省 汕头市|转变 作风 纪实
红布上的 名字|已经 签得|密密 麻麻
开展|重建 信用$重塑 形象 活动的|一次 宣言
为|各位 实业家|各位 朋友|提供|发展 商机
将|工业 项目 用地|地价 削减 至
生产 花花公子$花雨伞 等品牌的|预发 实业 公司的|刘丰 说
潮阳市|关埠镇 桥头村$来了 几位|商人 打扮的 陌生人
来的 人中$那位|身材 魁梧|头发 花白的|中年人|眼圈 发红了
随着|这个 水厂$明年 三月份的|竣工 通水
从 破旧的 房屋$迁到|宽敞 楼房的 特困户
大家|形象地 称之为|零点 起跑的$阳光 作业
人员的|进退 留转|又成了|热点 问题
全过程 都 体现了|公开|平等|竞争|择优的 原则
大专 以上|学历的 比例|提高了
其 主要 根源是$干部 人事|体制 改革 滞后
在|推行 和 完善|竞争 上岗$公开 选拔 等|干部 选拔|制度的 同时
还 默默地 流淌着|这么 一条$叫|错开河的 小河
心底|就 油然 而生|骄傲 和 自豪$为我们 拥有 这样的$治水 英雄
并给 我的|同事 脸上|罩上 一层|肃穆 时
山水$便 常常 成为|记载 人类 功绩的$另一种 形式的 纪念碑
错开河 是|鲧|开山 治水时 留下的
鲧 开凿的|这条 小河道$没有 捆缚住|狂暴 肆虐的 黄河水
于是|长叹 一声后|拔剑 自刎
鲧的 儿子|大禹|继承 父亲|未竟的 事业
较之 与|山海经中|息壤 治水的$怪诞 不经
鲧 和 它的|错开河的 存在$是 情理之中的 事
我们 常说|真理 就在|谬误的 隔壁
一座 为民 造福|虽死 无悔的 纪念碑
一泓|幽碧的 潭水$接纳着|訇然 作响的 瀑布
一个 着红衫的|年轻 女子$正蹲在 溪水边|一下 一下地 淘麦
金黄 饱满的 麦粒$在 阳光下|闪烁着|诱人的 光泽
两岸|苍黑的 巨石上 那 一道道|白色的 凿痕
不知道|是不是 那位|叫|鲧的 先民$留下的 印记
大禹|就是在 错开河边$久久 沉思 之后
黄皮肤|黑头发的 人群$组成的|连绵 不断的 队伍
唐代 诗人 刘禹锡$曾经|如此 说过
在 山上 也|寻不到 一枚|仙人的 脚印
也|听不到 一声$隐隐的 龙吟
连 山神|都 惶惑 不宁|而|无从 投诉
一条|天然 拙朴的|小小 山径$便 自充 向导
绿树|打开 一伞伞|欲湿 人衣的 清凉
久住 尘嚣的 我们|只觉|风尘 尽卸
只有 我们的 脚步声|和|对话声$碰破 山中|浑然 一体的 寂静
即使 空中|有 一两只|来历 不明的 飞鸟
哪里 像|此中的 山鸟$无束 无拘
大约是|欲说 还休的|蝉声 泄密吧
只见|接青 叠翠的|山的 重围 深处
一帘 白银|从 山崖|倾泻 而下
像 逃学的 孩子$迟迟|不肯 回 家
其中 有句 是|原上鸟|呼 山上鸟
唤醒的$是我 已|尘封 多年的 记忆
来自|上海的 朋友$出过|好几本 散文集
许多 篇章|都是 写|现代人的|生存 状态$和 无奈 心情
每天 奔波 在|滚滚 红尘 之中
被|现代 工业 文明|和|商业 功利性$浸染了的|许多 名山
我又 忍不住|引经 据典 起来
远方的 城市$也在|喊 我们 归去
我们 只好|和 山神|挥一挥 手
在 林间 小道的|牵引 下$匆匆 下山
那|车声 隆隆|人声 喧喧|市声 嚣嚣的|天罗 地网
在 一派|春之 风光的|城市 大背景$陪衬 之下
这次 住在|大庆 让胡路区的 那家$临水的 宾馆
那个 市的|区与区 之间|就|十分的 绰远
但 现在$比之 只有|二十岁 城龄的 大庆市
诗人的 朋友$开着 他 那辆|日产的 五十铃
又稳 又快地$行驶在 大庆市的|世纪 大道上
而且 还|伴随着 一种|宜人的 宁静 与 温馨
在 这个$八车道|高水准的 街道上 行驶
而且 敞亮得|毫无|大都市的 那种$高楼 夹峙的|峡谷感 憋闷感
大庆的 羊群$则是|融化在 盐碱滩上的|一片片|褐色的 阴影
害得 口上|寡淡的 我们$要 开车 跑很远
最令人 称绝的 是|涮|圆圆的 饺子 皮儿
对 原来|政企 合一的|邮电部的 逐步 拆分
接入 服务的 放开|促进了|互联网的 普及
目前 联通的$第二 国家|公众 长话网$渐成 气候
联通的|国内 长话网$已 通达 全国|多个 城市
电信 行业|与 民航 电力等$其他|垄断 行业 相比
都 有着|不可 低估的|积极 作用
长话 计费 单元|由 分钟|改为 秒钟
上|互联网 浏览 信息$还 只是|个别人的 特权
上网 已成为|普通人的 乐趣
电信的|电路 出租费|也 大幅 下调
城乡 差别 大小$是|社会 发展 水平的|一把 标尺
人们 手持 电话|边走 边聊$已成|街头 风景
中兴 通讯|现已 成为|民族 通信 设备 厂商的|领军者
压缩 开支|并 裁员 至|万人 以下
好的 制度 在|选人 用人中|起到|根本性 作用
率先 在|省委 省政府 机关|推行$中层 干部|全员 竞争 上岗
好的 选人 作风$是 落实|好的 选人 制度的|重要 保证
形成了|一系列|比较 配套的 制度
客户 只需要 使用|现成的 包装$和 准备 简单的|出口 文件
去年 和 今年$共 出口 尿素|五十六 万吨$催化剂|一千二百吨
记者 问及 今后|我国 将 允许|外商 设立$独资 旅行社
类似|国旅 总社的|大型 旅游 企业$准备 如何 应对
迄今|仅接待 海外 游客|累计 就达$二十 余万 人次
我们 在 全球|拥有 多家|稳定的 客户
在 西欧 北美的|入境游 市场|具有|明显 优势
旅游业 竞争|更加 离不开|信息 技术 竞争
全方位地 拓展|旅游 电子 商务
总社的 团队|接待 业务$全部 借助|网络 传递
并 推出了|千禧|理财|鸿泰|养老等|近 十个 分红 产品
多名|下岗 失业 人员$接受了 计算机|应用 知识的 培训
下岗 职工$利用 援助的 物资$进行|相关 培训
煤炭 行业|实现了 整体 扭亏
按 市场 需求|实施|增产 增运 增供
避免|煤炭 价格的|过猛 回升
李瑞环|乔石|叶选平等$分别以|不同的 方式$表示了 慰问
七月 八日$因|多脏器 功能 衰竭$在|广州 逝世
为 岭南 画派|开创了 一条 新路
把 发案|破案 责任$落实到 街乡|第一 责任人$和|派出 所长 身上
今年 全区 街乡的|安全 居家 委会|安全 单位 达标率$分别为|百分之三 和|百分之五
由|治安 民警$刑警$巡警$三警 合一的|指挥 中心|业已 建立
对 无身份证件$无|暂住证 人员|加大 清查|收容 力度
共有|二十 多名|干部 群众|听了 宣讲
解决了 当地|有路 无桥的 问题
省委 常委|将 重点|就 技术 改造|和|就业等 问题$开展 调研
今天的|人民大会堂 小礼堂$成了|欢乐的 海洋
河南省|郑州市 二七区|检察院 检察长|侯耀生
四川省 泸州市|检察院|副检察长|钟长鸣
明年 领导 班子|建设的 任务|非常 繁重
要以 十六大 组织|准备 换届 调整$和|作风 建设 为 重点
大力 选拔|靠得住 有本事的|优秀 干部
坚持 把|用好的 作风 选人$作为|选贤 任能的|重要 保证
认真 贯彻|六中全会 决定 提出的$五 坚持$五 不准的 要求
抓紧 做好|培养 吸引$和 用好|各方面 人才的 工作
努力 营造|拴心 留人的|良好 环境
北京市 体育局 局长|孙康林$当选 主席
有|多次 获得|国际 比赛 金牌的|田亮$王励勤$陶璐娜
黄金宝 连夺|三站 桂冠
以|不到 一轮 优势$战胜 麦克 唐纳|和 汤学忠
捷安特 亚洲 车队的|杜胜吉$仍比 离他 最近的|中国 选手|快 一秒
首任 会长$由 中国银行|汉城 分行行长|岳毅 担任
美国 拟把|阿战俘 押往|关塔 那摩 基地
人们 排起了|长长的 队伍$等待 领取 粮食
由于 阿富汗|临时 政府的 组建
其中 三人|被 关在|阿富汗 南部 重镇$坎大哈 附近
另外 一人|被 关在 一艘$在|阿拉伯 海上 巡弋的|美国 巡洋舰上
将|印巴 两国|派驻|各自 使馆的 人员|减少 一半
造成了 包括|武装 分子 在内的$三人 死亡
就在 印巴|在 外交上|步步 进逼 之时
在 印议会 大厦|遭袭案 发生后 不久
通过 和平 谈判$解决 双方 在|克什米尔 问题上的 争端
在座的 中国 企业家们$与|恩盖桑 总理 一起|共进 晚餐
防止 埃博拉 病毒|出血热$传入 我国
加蓬 爆发|埃博拉 病毒|出血热
表现 为$发热$头痛$肌痛$结膜 充血 等
几天后 可 出现$呕吐$腹痛$腹泻$咽痛
严重 病例 可出现$无 黄疸型 肝炎|和 胰腺炎
告知 必要的|个人 防护 措施
雪人 小丑$吸引着 过往 行人|特别是 孩子们
第三套 节目|将 直播|全国 电视|相声 大赛
今日 直播 名为$今夜 相声 灿烂的|大赛 颁奖 晚会
北京 应该在|这方面|思想 更解放 一些
困扰|美中 贸易 关系 多年的|一个 难题$由此 结束
美国 国会|根据|杰克逊 瓦尼克 修正案
一直对|是否 给予 中国|最惠国 待遇$进行|年度 审议
但|年度 审议的 法律 程序$并未|因此 而 改变
这一 问题$一直是|掣肘 美中 两国 贸易 关系的|关键 问题 之一
将 严格 遵守|世贸 组织 规则
上厕所|起码 要跑|三四百米 远
有的 乘客|还 提着|大包 小包
可|广大 乘客的 麻烦|就大了
如到|政府 机构 办事|找不到 人
是|自己 麻烦 一点|给|群众 提供 方便
李岚清 在|认真 听取了|两位 代表的|发言 后$发表了 讲话
显示了|海外 中华 儿女$对 祖国的|赤子 之心
吸引 更多的|海外 优秀 人才|为 国 服务
有关 部门|要 采取|切实 有效 措施
国家 逐年 加大$对 科技 和|教育 事业的|支持 力度
中华民族 有|尊师 重教的|优良 传统
完善 国家|助学 贷款|有关 措施$和 贴息 办法
打黑 除恶的 关键$是|挖出 他们的 保护伞
一是$地方 保护主义|和|保护伞的 存在
特别 对|危害 生命 健康的|伪劣 商品$要 加大|刑事 处罚 力度
地方 工业 盈亏 相抵后|实现 利润
结束了|一九九九年 以来$连续 五年的 亏损
对 有令 不行$有禁 不止的$要 严肃 处理
申请人|应当 自 接到|正式 申请表 之日起$三年内|完成 筹建 工作
应当 按照 其|注册 资本|或者 营运 资金 总额的|百分之 六十$提取 保证金
保证金$除|外资 保险 公司 清算时$用于|清偿 债务外
包括 人寿 保险$健康 保险$意外 伤害 保险等|保险 业务
外国 保险 公司|分公司$应当于|每一 会计 年度|终了后 十个月内
由 中国 保监会$依法 及时 组织 成立|清算组$进行 清算
一$未按照 规定|提交 报送 有关|文件 资料|和|书面 报告的
进口 配额 管理 部门$可以在|下一 年度$对其 扣减|相应的 配额
进口 经营者$凭|进口 许可证 管理 部门|发放的|进口 许可证
应当 限于|为$保证 实施 管理|所必需的 文件|和 资料
除 本条例|第四十七条 规定的 情形外
不得 以|非商业 因素$拒绝 其他 企业|或者|组织的 委托
包括|国际 收支|发生 严重 失衡$或者 受到|严重 失衡 威胁时
一$发生|严重 自然 灾害等|异常 情况
二$出口 经营 秩序$严重 混乱
国务院|外经贸 主管 部门$并可以 撤销 其$对外 贸易 经营 许可
依照 刑法|关于 走私罪 或者|非法 经营罪的 规定
对|本条例的 条款 顺序$作 相应调整
八一队|已难 重现 往日|温酒 斩华雄的 洒脱
眼看 着|过去的 手下 败将|越来越 难对付
除了 内线 实力|大打 折扣 外
球员们的 心理$不可能|不发生 变化
对方|身高 两米的 中锋|盖斯$就让 八一队 内线|备感 压力
经过 开赛 以来|几轮的 磨合
乃至|联赛的 发展 来说$也并非 坏事
这样的 运动会$最 贴近 咱农民
想不想 参加|全国 农民 运动会
一些|专门 从事|农民 体育 工作的 人士|也 承认
农民 运动会$正 面临|远离 农民的 窘境
本次 全国|乡村 青年|大力士 擂台赛$所设的 十个 项目
设身 处地|为 广大 农民|考虑的 问题
欢迎 载誉 归来的|诸宸$和 参赛的|中国 国际 象棋队|全体 成员
诸宸的 教练|徐俊等|分别 在|会上 讲话
国家 体育 总局|局长 助理|何慧娴$在会上 向|诸宸 等人 颁奖
马晓春的 黑棋|一直 走得|比较 稳健
学生的 阅读|和 理解 能力$有待|进一步 改进
巴西|六岁 以下的 儿童|应上 幼儿园
无论 是|高中 毕业|还是 职高 毕业$都 可入 大学
在|迟到的 这段 时间|我们|干什么 去了
正是|表达了 这样 一种|知耻而 后勇的 觉醒
不久前|发生的 两件事$却都 震动了|比利时 社会
是|比利时|航空 公司的 破产
当地的 一家|英文 杂志$就以 爬升
能用 五种 语言$演绎|不同 风格的 歌曲
深深地 拨动着|每一位 来客的 心弦
刘三姐 达坂城的 姑娘|草原 之夜$一一 道来
我们 这一代人$都是 听着|甲壳虫的 音乐 长大的
成千 上万的 人$到 利物浦|市中心的 广场上
甲壳虫|以 自己|奇特的 演唱 风格
在 流行 乐坛上$掀起了 一场|波澜 壮阔的 革命
英国人 称|甲壳虫 是|不列颠的 财富|和 骄傲
英国 王室$授予 甲壳虫$帝国 勋章
甲壳虫 在|精神上|很好地 体现了|摇滚乐的 真谛
它 不仅 是|更 年轻|更 大众$和 更富|旋律的 文化
甲壳虫|最受 歌迷 崇拜的 成员|约翰 列农
统一 前的|德意志 联邦 共和国$在 国际上|有一个 绰号
当时 德国的|外交 政策$还|深深地 打着|战后 时代的 烙印
德国|不仅 充当了 关于|阿富汗 前途|磋商 会议的 东道主
医护 人员|还 定期 回顾|和|分析 病人的|治疗 效果
也|不得以 任何 名义$在 香港 从事|行医 义诊 等|中医 医疗 活动
社科 文献 出版社$日前 推出 著名的|皮书 系列
已被|人类 孟德尔|遗传病 目录 收编
现代 汉语 书面语中$异形词的 存在
给出了|三组 异形词的|推荐 使用 词形
意在 体现|词汇 规范的|柔性 原则
规定了 汉字的 五种|基本 笔形|及 排列 次序 为$横$竖$撇$点$折
准予 备案|高等 职业 技术 学院所
对|西部 地区 高校|和 少数民族 考生$给予|适当 降分的 照顾
国务院 学位 委员会$授权|四个 西部 省区市$自行 审批 硕士点
共 增列了|十个 博士点$和|七个 硕士点
配合 西部 地区|三亿元|国债 项目的 实施
中央 财政 设立的$三万元 扫盲 专项|补助 经费
积极 推进|国家|助学 贷款 制度的 落实
国家 从|福利 彩票|公益金中 拨出
各 乡镇|会计 结算 中心的 成立
河北省 栾城县 政协$积极 投身|当地 经济 建设
从而 实现|生产 资本|与 流通 资本的|整合 运作
中华人民共和国 韶山 海关$三月 一日$在 湘潭|正式 开关
年产|一百万吨的 煤矿$就算是|大煤矿了
辛辛 苦苦|凑够了 钱|花了 数年 时间$完成了 技改
兴隆庄 煤矿|靠的 就是$自己 拥有的|核心 技术
如果 搞不清|全国|或 地区的|基本 单位 数量
普查 资料的|调查 年度|是 八 年
加之 缺乏|必要的|信息 互换 制度
积极 寻求|相互 衔接的 办法
曾 参与 组织|上甘岭|金城 等 战役的|后勤 保障
这是 根据|省委 常委|宣传部 部长|骆惠宁的 提议
受到了 全省|基层 干部 群众$和|各 新闻 单位的|普遍 好评
应|全国 人大|常委会的 邀请
这个 条约|将|推动 中俄 关系|长期 稳定|向前 发展
昨天$俄罗斯 国家 杜马|批准了|俄中 睦邻 友好 合作 条约
为|中俄 关系 确定了|不结盟$不对抗$不针对 第三国的 性质
国务院 港澳|事务 办公室 主任|廖晖$参加了 会见
常委会 组成 人员$在对 草案|基本 给予 肯定的 同时
本法 也应该|强调 规范|中小 企业$本身的 行为
草案中 称|水资源 包括|地表水$和 地下水
国家 鼓励|单位 和 个人$开发 利用|海水的 淡化
统一 到 中央|关于 明年 工作的|总的 要求$和 总的|部署 上来
我们 要|紧密 团结在$以|江泽民 同志 为核心的|党中央 周围
英国 政府|当天|又向 阿富汗|增派了 三百名 士兵
拉登 在 录像中 指责$美国 和 西方|憎恨 伊斯兰教
并称 事件的 目的$是 为了|迫使 美国|停止 对 以色列的 支持
我们|重视 阿盟的 作用|和 影响
赞赏 阿盟|为|推动 中阿 关系|所做的 努力
以及 关于|成立 中阿 论坛的 倡议
所有 阿拉伯 国家$都 重视 发展|同 中国的|友好 合作
十堰 有机 农业$既 保护了|水源区 生态
又 成为|农民 增收的|夺目 亮点
有机茶|有机 豆杂 面积$分别 超过 十万亩|和 十八 万亩
这里 竟连|一个 消火栓 也没有
墙上 几个|干粉 灭火器$早已 过期
随意 抽烟的 商贩$毫无 消防|安全 意识
加强|市场 价格|监督 检查的 通知
为|守法 企业|进一步 创造|宽松 环境
各地 要|积极 探索|采取|重组 兼并 改组 等|多种 形式$进行 改革
要|坚决 打破$地方 保护|和|部门 垄断
代表 机构的|设立 变更|和 注销
并且 没有因|违反 律师 职业 道德$执业 纪律|受到 处罚
并且 已在|中国 境外 执业|不少于 十年
一$在其 本国的|律师 执业 执照|已经 失效的
三$已经 丧失 本条例|第七条 规定 条件的
可以|直接向 受委托的$中国 律师|事务所的 律师$提出 要求
代表 机构|不得 聘用|中国 执业 律师
收缴的 罚款|以及|依法 没收的|违法 所得
或者 聘用的|辅助 人员|从事 法律 服务的
二$泄露 当事人的|商业 秘密$或者|个人 隐私的
对|应当 撤销|代表 机构$或者|代表 执业 许可
收回|执业 执照|执业 证书的$不予 撤销 收回
七$有|不严格 执法$或者|滥用 职权的|其他 行为
三$诋毁 其他|旅行社的 名誉
五$扰乱 旅游 市场 秩序的$其他 行为
使 旅游者 权益|受到 损害的
组织|出境 旅游的|境内 旅行社$应当 承担|赔偿 责任
然后 再向|违约的|境外 旅行社$追偿
任何 单位|和|个人$不得 挪用|质量 保证金
应当 遵循$诚实 信用的 原则
三$有|提单 客票|或者|多式 联运 单证
二$有|固定的 营业 场所$和|必要的 营业 设施
国际 班轮|运输 经营 资格$自|期满 之日起|丧失
无船 承运 业务 经营者$运价 本上|载明的 运价
二$在|会计 账簿 之处$暗中 给予|托运人 回扣
一$办理 船舶|进出 港口 手续
办理|货物 集装箱的 托运|和 中转
其 服务 涉及|中国 港口|某一 航线的|承运 份额
书面 通知$被 调查人|利害 关系人
应当 告知|当事人|有 要求 举行|听证的 权利
未履行|本条例 规定的$备案 手续的
或者|隐匿 谎报 有关|情况|和 资料的
扰乱|国际 海上|运输 市场 秩序的
届时|会有 很多|新面孔 登场
二零零五年|全国 女足|超霸杯赛$将于 六月 一日$在|无锡 体育 中心 举行
上海 女足|夺得 联赛|和|超级 联赛 双冠
福建 羽毛球队|四十五年|硕果 累累
福建队 还为 国家$培养|和 输送了 大批|优秀 教练员|和 运动员
捷安特 亚洲 车队的|三蒲 恭资$和|八一队的 马登胜$轮流 领先
捷安特 亚洲 车队的|杜胜吉$突出 重围
第十圈 形成|大队 人马|齐头 并进的$竞争 态势
比赛 明日 将|移师 中山$进行|一百 公里|绕圈 赛
哈尔滨队的 孙思音|摘取了|本次 赛事的|首枚 金牌
这是 孙思音|表演 优美的|平衡 动作
泰国 新政府的|内政部长|布拉猜边 颂汶$是|声威 最高的 部长
治理|街头 夜间 流莺$打击|外来 娼妓
其他 场所|突击 抽查 等办法
施以|长期 停业|巨额 罚款 等处罚
对|执行 不力|或 抗命 不遵的 官员$则|撤职 查办
这条街 曾是|青少年 吸毒 狂欢的$不夜城
布拉猜的|整治 措施$赢得了 各界的|广泛 支持
乃至 僧侣界$都 举行|集会 声援
下至 平民 百姓$不可 或缺的 主食
叙利亚 供应|与 内贸 部长$乌萨玛 宣布
价廉 物美的 大饼$吸引了|不少 买主
精白面 大饼|无法 同|全麦 大饼 相比
大饼 改革$既 收到|经济 效益
吸引了 欧洲|和|众多 媒体的 目光
近年来$瑞典|克朗|不断 贬值
哈帕兰达 和|其他 两个|瑞典 市镇$正式 向|欧盟 提出
如果|哈帕兰达 这次$不选择 使用 欧元
瑞典|哈帕兰达 超市内$标有|多种 货币 价格的 价签
如果 问一问|委内瑞拉|普通 老百姓$最担心的 是什么
委内瑞拉的|社会 治安差$是 出了名的
政府 派遣|国民 警卫队$协助|城市 警察|巡逻 首都的 街道
首都|加拉加斯 警方$还 聘请了|美国 前纽约 警察 局长$为 顾问
南非|夸祖鲁纳 塔尔省的 一名|农村 少年|艾滋病 患者
体察 艾滋病|逞凶 肆虐的 惨状
使|非洲的 人均 寿命$从 五十岁|降至 四十三岁
呼吁 社会$尊重|和 理解|艾滋病 患者
哈利波特|年年 名列|畅销书 榜首
改编 哈利波特$是|电影史上的|一次 盛举
反映的 是|善 战胜 恶的|永恒 主题
小说 和 电影$将|现实 与 科幻|巧妙地 结合 起来
哈利波特 与 魔法石$这一|近乎 完美的|文化 商品
它 不仅在|本国 和|欧洲 国家|引起 轰动
并获 奥斯卡|最佳|外语片 提名
心灵|与 情感的 快乐$是|人人 可 企及的
这个 世界 有|太多的|兴衰 沉浮
小人物 常显得|平庸$而 无奈
纽约|世贸 大厦的 废墟$还在 冒烟
邳州|艾 山西 大桥|邳苍 分洪道|西偏泓
上海 青浦 急水港$主要|出湖 断面
这套 软件 实现了|建筑物群|整体 资源的$统一 调度 协同
在 四川|乃至 中国$都属|欠 发达 地区
以|真抓 实干的|工作 作风|开展 工作
今年 一月的|日均 页面 访问量$与|去年 同期 相比$增长了 三倍
以其 强劲的|后续 开发 能力$和|丰富的 德育 资源
致使|品种权 所有人|和 引种者|蒙受 损失
采用|基因 工程 等|高科技 手段|培育 成功的$抗虫 杨树 新品种
假冒 树苗$也给 广大 林农|带来|无法 挽回的|巨大 损失
详细 规定了|三类 人民法院$可以 受理|和 审判的 案件
在|云南省 腾冲县|和 顺乡 农村$有 一座|别致 新颖的 建筑
足不 出户|可以 查阅|图书馆的 书籍
坐在 家中 购物|这些 梦想$如今|都 成为了 现实
网络的 发展|使|图书馆 日益 发挥$资源 共享的 整体 效应
上海 图书馆|五万册 善本书$实现了 数字化
大大 改变了|传统的|服务 方式
四川|龙虎 酒业 有限公司$举办了|保健酒 专家 品评会
龙虎 系列 保健酒$是|五粮液 集团 开发的|功能性 白酒
发动机|尾气 排放$达到|欧洲 二号 标准
为 开发 建设|松山湖$提供 充足的|资金 保证
新兴的 企业|主要 分布在$浙$粤$苏$鲁 几省
仅|浙江 海宁|就有|十余家 企业
但 祖国 大陆|家纺的 发展$还存在|设计 人员 匮乏
比|设计 生产 能力$翻了 一番
使|矿井的 煤炭 年产量$达到了|一百万吨 水平
由于|不断 在|综采|放顶煤 工艺上|进行 改造
兴隆庄 煤矿|单产 纪录$一次次 被|自己 刷新
内蒙古 东部|东北的 气温|将 下降
更应 成为|传递 友谊|和 合作的 桥梁
陆地 边界|勘界 立碑 工作|十分 具体 辛苦
发扬|吃苦 耐劳|真诚 合作的 精神
民营 科技 企业$是靠|党的 政策|发展 起来的
我省|陕南 陕北 一些|贫困 农村$急需 从|党报中|了解 党的 政策
陕西 省委 副书记|袁纯清|首先 讲话
由|新闻 出版 总署 主办的$国家 图书奖$于|二零零一年 设立
说到|中国 有些 大学生|素质 欠佳的 情况
有的 公司|被|几个 新聘的 学生|弄得 很被动
他们|不等 电梯里的 人|先出来$就|冲进 电梯
当然 与|学校 教育中的|某些 缺陷 有关
即|过分 溺爱$甚至 纵容 子女
没有 注意 培养他们|爱 学习$爱 劳动$帮助 他人等|良好 习惯
很 可能|只 拿到 低分$甚至 不及格
这 需要 才能|和 渊博的|生活 知识
凡|做 父母者$都 理应|好好 琢磨
要|摒弃 那种|一味 惯孩子的|错误 做法
也要 纠正|只重 分数$不重|思想 道德 熏陶的|片面性
同时 还|逮捕了 近 三千名$涉嫌|反 政府的|武装 人员
人们 不应|轻率 谈论|开战 问题
向 细菌战的|受害者 道歉$并|赔偿 损失
支持 细菌战 诉讼的|日本 各团体|和 人士$三日 在 东京|举行 游行
来自|中国的 两名 原告$出庭 作证
北约 似乎|已经 找到了 答案
北约 需要|发展|与 俄的 关系
取代 目前的$北约 俄罗斯|常设 联合 理事会
与 俄领导人|探讨|双方 合作的|新机制$和 新内容
四月 上旬$北约 外长 会议$正式 决定
为|北约 与 俄的|伙伴 关系$增添|新的 动力|和 内容
如|防止 武器 扩散|军控 反恐$和 导弹|防御 等 方面
为|欧盟 处理 危机时|使用 北约 资源$扫清了 一大 障碍
双方 已就|欧盟 利用|北约 资源 问题$达成 原则 协议
欧盟 拉肯|首脑 会议$又|未能 解决 这个 问题
但 这|并未 影响 北约$要|加强 与|欧盟 合作的|态度 和 行动
尽快 弥补|北约 在|三个 关键 领域内|存在的|防御 缺陷
二$土地换 和平 原则$及|以前 和谈|所 取得的 成果$应 受到 尊重
支持 穆巴拉克 总统$关于 召开|国际 反恐|大会的 主张
江主席|也 期待着 同|穆巴拉克 总统$再次 会面
中国 反对 将|恐怖主义$与 特定的|民族 宗教|和 地区 挂钩
安徽省|加快 建设|林业 生态 网络 体系
目前 全省|已 启动的|六大 工程是
县 以上 城市|建成区|绿化 覆盖率$达 以上|挂钩|烫烫|衸
建设 银行 行长|王雪冰$在|签约 仪式上 说
治理|餐桌 污染|年内 目标|初步 实现
福建省|全面 开展|治理|餐桌 污染
省委 省政府$又 将它 列为$为民 办的|三件 实事 之一
对|该批 货物|采取了$焚毁 填埋 处理
毛泽东 诞辰|一百零八 周年 之际
这些 酷似|玻璃棒的 圆柱体
预制 棒的|生产|和 供应$由此 成为|制约|该产业 发展的 瓶颈
小浪底 水利 枢纽|主体 工程|全部 完工
小浪底 水利 枢纽$位于 黄河 中游|最后 一个|峡谷的 出口
自|九八年 一月 开始$首台|机组 蜗壳|安装 以来
切实 控制|农村 初中的|辍学率
一些 传播|封建 迷信的 挂历$蒙混 上市
在 这些|类型 各异|档次 不同的 挂历上
有的 还印有|生男 生女 示意图$以及|周公 解梦的 注释
有些人 就会|不由 自主地$干出 种种|荒唐事来
二期 工程|包括 三台|十万 立方米 原油 储罐$及 配套工程
成为 国内 最大的|原油 中转 基地
图为 已 建成的|一期 工程|码头 一景
关键 硬件|和 软件|依赖 进口
增强|为民 办事的|透明度$和 公正性
各地|公开 逮捕|和|宣判了 一批$严重 刑事|犯罪 分子
把|功夫 下到|着力|治本 上来
不能 适应|水污染|防治的 要求
巧遇|进村 入户 走访的|市委书记$郭兆信
市委领导|经常|不打 招呼|直奔 一线
东阿县|认真 解决|群众 反映的|热点 难点 问题
从|寸土寸金的 地皮中$挤出|十多 平方公里
清华|北大|哈工大等 名校$都将 在这里|设立|育才 基地
高新技术 产品 产值|约占|工业 总产值的 一半
钦州 既 享有|国家对 民族 地区的|优惠 政策$及|边境 贸易 政策
图为|铺里镇 一艺人|在 聚精会神|绘制|形形色色的 灯笼
可|仅几天$垃圾堆 又 出现了
过往的|汽车 驾驶员|怨声载道
想 购买|宪法$刑法$婚姻法$消费者 权益 保护法|等 法律 单行本
知法 懂法|已成为 公民的 共识
被$剥了 皮的|沙兰 杨树|在|寒风中 哭泣
得佳 电视|制造 有限公司$是 九八年|三月 成立的
蒙骗|为其 验资的|会计师 事务所
只有党的|各级 领导干部$真正地 起到|表率 作用
我们党 力量的 源泉$在于|广大 人民群众的 拥护|和 支持
党|就能 得到|人民 群众的|信赖 与 支持
党的 事业|就|难免 遭受|损失|和 挫折
党风|在 客观上|是|民风的 楷模
对 民风 起着|引导 制约|和|决定的 作用
欲正 党风$必须 先 搞好|领导 干部的|作风 建设
在|任何 情况下$都要 做到|慎独
看看|与 党的 要求|还有|多大 差距
波兰 总统|克瓦 希涅夫斯基 称
并于|去年 促成了|举世闻名的|圆桌 会议
曾经|共 患难的|各 党派 领导人$争夺 权利
登上|联邦 议会 讲坛$为 保护|土著人 权利$大声 疾呼
从|恰帕斯州 冲突 地区|撤走|全部 政府军
商店 纷纷 打出|庆祝 甩卖的 广告
街头 分发的|号外$被|一抢 而空
雅子 成婚 以后$一直 担负着|生育|接班人的 压力
日本 首相|小泉纯一郎 表示
今年 是|埃及 总统|胡斯尼 穆巴拉克$当政 三周年
作为|阿拉伯 世界的|传统 大国
在|过去的 一年半 期间里$埃镑|已 三次|小幅 贬值
但|迟迟 没有 见到|曾 许诺的$经济 援助
靠|微薄 退休金|度日的 老人
如|说服 药厂$向 艾滋病 严重的|发展中 国家$提供|廉价的 药品
使|贫苦的 病人|也能 得到 治疗
使|阿富汗 妇女|生活在|水深 火热 之中
三岁的 扎尔帕娜$就是|其中 之一
她 决心|重新 拾起|两年前|丢掉的 功课
值得 一提的 是$该赛段 一个|陡坡的 落差$竟达 三十米
首钢队|关键 时刻$缺乏 领军 人物|也是 败因
对 查出的|有 执法 过错的|地税 干部$全部 进行了 追究
抽出|专人 接待|每天 零星 送物的|在押犯 亲属
吉林省|延边 朝鲜族 自治州|龙井市
有 公安 民警$在 市郊的 农田$发现了 歹徒$立即|鸣枪 示警
向 琵岩山|一人 多高的|玉米地里 逃窜
李兆林|左手|紧紧 抓住 尖刀
包抄 围捕的|战士们 赶到了
这是 李兆林的|军旅 座右铭
每一个 动作|都|高标准 要求 自己
李兆林 已经|连续 三年|没有 休|探亲假
李兆林|在 腰上|系一根 绳子
大家 见到|他 眉毛|被 烧焦了
手臂 被|树枝 剐得|血迹 斑斑
新战士 霍然刚|衣服 被 刮坏了
市委 市政府|把|解决 他们的|急难 盼怨$作为|当务 之急
市里 要求|基层 组织$为 每户|挂靠 一家|龙头 企业
在 农村|深入 实施|四通|五改|六进村 工程
对 民警的|管理 触角$延伸到 生活圈|社交圈
使 队伍|防腐 拒变的|免疫 机制$不断 增强
着重 研讨|我国 加入|世贸 组织后
将 有助于|充分 发挥|各|债转股 企业的 优势
加强 在|产品 购销$资金 结算$及|技术 交流 等|方面的 合作
平度 招远|莱阳 掖县|边区 工作团的$大队长 副团长
他 蒙受的|不白 之冤$得以|彻底 平反
致使 两岸|恢复 对话的$既有 基础|迭遭 破坏
我们 坚持|一个 中国 原则的 立场$是|不可 动摇的
通过|各种 方式$来 实现 其|分裂 图谋
对 那些|鼓吹过|从事过|追随过 台独的 人
国际 形势的|发展 趋势$仍 将是|道路 曲折$前途 光明
法国|宪法 委员会$已|确定 两大|选举的 日期
尽管 大选的 帷幕|尚未 拉开
但|人们 已 闻到了|选战的 硝烟味
两位 执政者的|党派 色彩$明显 增强
发生|多数派 变更 总统$丧失 对|议会 控制的 情况
以|社会党 为 主体的 左翼$执政|四年半
希拉克|熟练 驾驭着|总统化的|法国 外交
树立起 一个|有 欧洲|和 世界 视野的$领袖 形象
希拉克|和 若斯潘的 民意分$不相 上下
余 者|分别 属于|巴解 组织|主流派 法塔赫$和|伊斯兰 圣战 组织
在一次|宫廷 宴会上$他把 毒品|放进了|布里坦 尼克斯的 酒中
施维尔克曼$感到 他的|左裤腿|略微 有点 潮
他 从 西班牙 马略尔卡岛|买 来一 只 幼 狮
可 如今|他|干瘪 已 久的 嘴里|又 长 出了 整齐的 新 牙
赶快 忘记他 那 张|干瘪的|灰色的 脸
她 决|不愿 向 侵略者|出卖|自己的 肉体
侵略者 一 次 又 一 次地 烧毁了|帕兰奎
法的 海军 掠夺 者|是 一个|沉重的 打击
正当 拿破仑|波拿 巴|侵略 欧洲的 时候
它 把|唾液|滴进 你的 毛细血管 里|与你的 血混合
使 窃贼 无法 把 甘油 炸药 放进 去
按照 跳蚤的|个|和 它的 跳远 距离的 比例
但 听说 爸爸 是个 手艺|高超的 鞋匠
五 郎 用 有 毛病的 腿 支撑着|慢慢地 站起来
而是 驱使他 跌进了|无法 回头的|罪恶 深渊
维 多 克创办了|世界上 第一 个|私人 侦探的 咨询 机构
这 是 有人 踏着 走廊木地板|散播出来的 声音
原因 是 在 一次 见义勇为的 行动 中|得罪了|法国 人
是 由于 我 对|戴 高乐 将军|安葬的 情况|略 有 所 知
掠夺 和 威吓 他人 等等|及 其他 戒律
这种 常 服 就 是 古代 俗 人的 服装|略 加改变的
趁 此 我 谢谢 藏本 先生|协助 我们|尽快 澄清了|真相
英国 趁 英|法 争夺 海上 霸权|和|法国 侵略军 在 海地 惨败之机
这些 海豚 一边 发出|各种各样的 声音
当我的 老朋友|布里恩 怂恿 我 不妨 抽一支 时
不愿 成为 当时 席卷 爱尔兰岛 饥荒的 牺牲品
按照 应有的 礼貌|说一声 谢谢 你
同时 喉咙 里|发出 一阵 喑哑的 声音
有 几 只 小鸟|停在一根 电线上|嘁嘁喳喳地 叫着
这个 小老头|把 圣诞 礼物|由 烟囱|放进|这家 人家的|壁炉 里
在 一位 铁匠的|炼 炉旁 停了 下来
说 这个 女 妖怪 偷偷地|从 烟囱|钻 进 屋里
木匠 盖 房子的 时候|则可以 对照 设计图
奥基夫 从 耶 普 人那里|得到 许多 椰 仁干|作为 报酬
他像 一个 永远 压 不 垮的 英雄 那样|轻松 愉悦地说
你总 是 没完没了地 嚷嚷着 写 书 写 书 写书
高昂的 乐观主义 精神|和 运筹帷幄的 雄才大略
终因|熬 不过 饥荒|而 倒 在 荒野 里了
他们 没有 好好地|教教 您 普通 礼貌 中的|最 根本的 规矩
然而|最终 都 像 赶 牲口 一样|被 全部|逮 送 回来
毛躁的 小伙子|竟 一 变 而 为 翩翩 公子
诗是 巡 道人的 小屋|在 火车 轰 隆隆 过去后|留下的 静寂
丝毫 也 没有 因 满腹牢骚|放慢 脚步
说得|他|她|它|哈哈大笑|呜呜大 哭|哼哼 嗯嗯|默|不 做声
一个 带着 柔软的 南方 口音的 声音 说道
我俩 当初|都|不 敢说|能 和 像|对|方 那样 倔强
蛤壳 和|风|只顾 一个劲地|把 沙子|吹进 我的 眼里
鸥 群 有时 也 会在 海边的 礁石上 打盹
只流了 一 半|就 被 浩瀚的 大漠 吮 尽了
他将 一个 二 角 五分的 硬币|丢进了 坐在 门口的 瞎汉的 帽子里
一面 迅速 而 有条不紊地 干开了
更打开 你 那|密 锁 严 扃的 心扉吧
就 感到 杰 里 离 他们 俩 越|亲近一分
他 偶然 还 提起|法源寺的 芍药|和 崇效寺的 牡丹
迫击炮 弹 还是落到了 一个|越南 小 村庄 开办的 孤儿院 里
乘务员|挨次 降下 一扇扇 老 是 卡得 死死的 窗户
才 端出 去 两 盘|炸 龙虾 片 和 馄饨
并 倾 囊 相 授|蒜 茸蘸酱与薄皮馄饨的做法
叽叽喳喳|直到 十一点 半|才 传来 四 起的 酣声
而 最佳 服装 设计师得主|艾迪斯赫德|说得 俏皮极了
我的|哥哥 姐姐们|都会 朝 我 龇牙咧嘴
婆婆 和 公公|听到了 我们的 声音|相当高兴
有 再 多的 学问|也 不要 轻易 卖弄
便 拿起 他 放在 露诗的 炉子 上 烧 热了的 烙铁
因为|怎 也 抛却 不 了|那 一丝 属于情绪|却|不 属于现实的 东西
另外 一些|精致的 挂历|以及 办公 桌上的 小 摆设
晃晃 悠悠地 飘落 到 一 张 床 垫上
当 一位 忧郁的 女子|说 出 一句 极 轻松的 俏皮话
神圣 如|宗教 主持 弥撒 用的|祭坛
也 意味着 穿 时髦的 鞋|戴 摩登的 发簪
谁 能知道|是 我 耍 它|还是 它在 耍 我
九死一生|闯过 阎罗殿的 女英雄
广告上 曾|画着 一只|咩咩 叫的 羊
给|目不斜视的 老夫子$却是 全运会 一位|玲珑 女操|开开 玩笑
他却 有点像|粗犷|而 口讷的 运动员
加米涅夫|让 赖 说出其$住宅 和|房间 摆设的|一些 特征
但|本质上$我们 还是|哈哈 笑笑的 孩子
然后|转过 身去$对他的 同伙$咕哝了 几句
与它 浓毛下 传出的|喀隆 喀隆的|心跳声
将从 法国的|罗讷河$把水 送到|阿尔及利亚
他 咧咧 嘴唇$露出 一个|歪歪 扭扭的 微笑
而且 还|串通 大姊|宋霭龄$一起 怂恿 小妹
他像 一个|掉进了 深坑里的|酒鬼 似的
但是|勒死 小白狗|还能 说得 过去
全家 靠|吃 鱼市上 卖剩的|鱼杂碎 过活
不 吸烟者的 咳嗽$持续 达|两周 以上
库利奇科夫$怎肯 错过|这么个 好机会
使|在 经过 一片|好皮肉上 想|吮血时$可以 紧紧地 抓住
也 不知|被 哪位|快手 将军$揣进了 私囊
老汉|背起 一个|装有 熟山药蛋的|干粮袋
他们 在|埃及 城市的|大街小巷 中$发出|喵喵的 叫声
他的 喽罗|便 服服 帖帖地$转而 效忠于 女主人
整个 院里|都 听得见 他们|欢天 喜地的 嚷嚷声
那我 为何要 活在|别人 为我|摆设好的 模子里
人们 就在|雨水|和 泥浆中|推推 搡搡
我的|孤傲 和|倔犟的 脾气|又 萌动了
要写|就 写写 那个|患了 血癌的|小姑娘吧
我 新婚的|嫂嫂 和 哥哥$在 我的|生日 那天|一同|外出 旅行
小男孩|对他 发现的|每一个 贝壳$都|哦哦地|一蹦 一跳地 叫着
一个|杂耍场的 主人$扮成 一个|满脸 胡子的|巴西 将军
库立奇 总统|有些 恼火地|咕哝 说
淡黄色 头发|一卷卷的$披在 她那|纤柔的|耳朵 后边
夏天的 音乐$是 木棒 沿|栅栏 敲的|当啷 响
想不到|板着脸的 杰弗雷$也 咧嘴 一笑
他 愤怒地|用 前爪$把 妻子的 头|按到 地上
粗鲁 而且|咋咋 唬唬地|强加 于人
能 望着|弥勒佛的 笑脸$消消 心头气
用 六个 爪$把 宝石|高高地 固定在|戒指 托上
这|只不过 是个|小家伙$在 嚷嚷 罢了
嫂嫂的 姐姐|及|他们的 孩子$都在 一次|车祸中$不幸 丧生
我上 书店里|买了 十套|油墨 喷香的|红楼梦
只是 嘴里|重复 嘟哝着|园丁|对她 说的 话
为|二十 啷当的 儿子$居然 懂得|如此 之多
只见|水塘边的 天鹅|正|扑棱着 翅膀
天文学家$阿鼎 梅讷尔$和|玛乔莉 梅纳尔 发现
俯身|看了 一眼|黑咕隆咚的 深井
突闻 一|浑厚 男中音$发出 一声 夸张的|啊 唷 哇
声如 炸雷|豁啷啷|直从 人们|头顶 碾过
用 金银 铜质|或|玉石 琢成的|各式 簪子 别起$像|道士 一样
将来 我|兴许 退休 后|写写 回忆录呢
全以为|功能 越多$越麻烦$越累赘$越多了 一次|坏的 机会
用她|健壮的 手$灵巧地|在碗中 团出 一个|胖胖的 糌粑
看看 门窗|都已 关严$才|提心 吊胆地 询问
世上 有的是|故作 深沉者$或|天性 木讷者
可以|带上 一杯|喷香的 咖啡|去 自修
并 提出了|最 透彻 解决 办法的|哪吒的 故事
肇事的|现代 哪吒们$还|不明 所以
由|张学良 将军 掌管的$辽宁|迫击炮厂 制造
我们 那 五个人$被|对岸 敌人的|迫击炮火 赶上了
出笼了|光 扒拉|算盘 珠子的 土政策
有了 洗衣机|便|不必 捼搓 衣服了
爷爷|用 锄头$把 田地里的 土|耪得 很松
用|饱掭 浓墨的 笔$抒写了|儿女 柔情
他俩|顺顺 溜溜地$走出了 校园
推推磨的 工作$交给了|力气 大的 来干
他就 作出|吮奶的 动作
却|总是 看见|蚂蚱|和 蝴蝶
把 锄头|绑在 肉掌上 耪地
一毛钱 能买|一磅 鱼杂碎呢
老人 簪花|不自羞
他|撇撇嘴 笑到
同 嫂嫂|一起 去了 市政厅
马丁 乜斜着眼|看着他
自然会|撙衣 节食|去买书
把那 糗事|忘得|一干 二净了
对手|再横 再奘
另一头|跪在 母羊|腹下 吮乳
只 听得|嗳唷 一声
他的 脸色|刷白
可|肚脐眼|撇嘴 揶揄道
如 蚂蚱|得病 中的 情景
卡罗 听到了|喵喵的|绝望 叫声
徐森玉曩|为|各大 图书馆 购书
以|刹刹 她的 气焰
老是|咩咩 叫唤
老叟 走近了
常常 为此|而 偷偷|打哕 作呕
其 喵喵 之声|见闻于|一里 之外
马路边|踉踉 呛呛者 有之
招待会 就是|几杯 色酒
小表弟|忽然 变了副|哭丧脸
我 不小心|崴了 脚脖
悲哀地 咩了 数声
淡泊 身后 一抔土
树 随风 拰摇着
这人 看上去 很|纷繷
敌人 用 迫击炮|攻击 山的 阳坢
这人 挺俖的
大雕|翸翔 于 山巅
吾 为其 无用|而 掊之
只剩下了 糗粮
竹匴子里 盛着米
有|村疃 数家 而已
看着 焸亮的 火光
他 看上去|更奘了
梃猪是|必需的 一道 工序
用 秸秆|扎成 稕子
腻腻 歪歪的|很是 让人 难受
也就是|配配音的 工作
给 汽车 喷喷漆
你|撇撇开 心里的 疙瘩
大家 乱呛呛了 一阵子
托人 帮你|求求情
你 绕绕道|或许 能过去
他 软软 和和地|躺在 那里
这篇 文章|还 需要 润润色
把 衣服|晒晒 干
早上 起床|刷刷 牙
我会 帮忙|送送 货的
这次 测试|也就是 填填词
第二年 她 生日
保健品|夸大 宣传|仍 较严重
经对 产品的|标签 标识 抽查
抽检 发现$有 十种 产品|在 标签|或 说明书中$存在|夸大 宣传 问题
各级 民政部门$要|抓紧 解决|灾区 群众的$安全 过冬 问题
确保 灾区 群众$有 房住$有 衣穿$有 饭吃
确保 不出|遗漏 和|不到位的 情况
解决 优抚|安置 工作 中的|热点 难点 问题
开展|丰富 多彩的|拥军 优属$和|军民 共建 活动
甬台温 高速公路$宁波 至|雁荡 山段$二十五日晨 通车
杭州 至|温州 时间$由 五小时|缩短到 四小时
超矿井|设计 生产 能力|三百万吨
而是|它的 一套|行之 有效的$内部 控制 体系
别说 我们 没有|犯错误的 想法
为什么 中广核|这样 看重 规矩
中广核 集团公司 董事长$昝云龙|告诉 我们
企业 文化$又 影响到|企业 生产 以外的|所有 领域
总经理 刘锡才$这样 诠释|中广核 内部|控制 系统的$精髓 程序
否则|不管 你自己|得没 得到 好处
一年|数十亿元的 采购$都要 通过|合同 部门
这样 严密 而又|相互 制约的 程序$就是 为了 安全
中广核$由一个|国家 没有|直接 拨款|投资的 企业
而且 又|滚动 发展出 一个|新的 核电站$岭澳 核电站
以 做到|及时 防止|纠正 违反|程序的 行为
发现|个别 员工$违反 公司 规定
将|公司 机密|泄漏给 供应商
公司 审计部$向 总经理|发了 一张卡
而|公司 却 采购了|价格 高的
所有的 卡|必须要 解释$或 整改
审计 部门的|最大 权力$可以 让你 停职
很多人 讲起|笔记本的 故事
虽然 没有 查出$办事 人员|拿回扣
但|查出 此事的|经办 过程$违反了 程序
深入 宣传|税收 工作的|重要性
比|上年 增收 超过|二千 亿元
坚决|禁止 各种 越权|减免税 行为
尽快 实现|税收 监控的|全面覆盖$不留 死角
严厉 查处 虚开|增值税|专用 发票 案件
一些 地方的|加油站|税收 秩序$十分 混乱
养成|终身 学习的|良好 习惯
建成后|通过 与之 相连的|三条|放射性 高速 公路$通向 全国 各地
马桑溪 大桥 是|重庆 环线|高速 公路上的$第二大|控制 工程
资源 短缺|是|全球 经济 发展$必须 面对的 一个|重大 问题
充分 发挥|电子 信息 技术$对 经济的|倍增 作用
该书 回顾了|改革 开放|多年来$我国|电子 工业|发展的 历程
以及|政府 在|产业 发展中|应起的 作用$进行了 论述
共同 开创|澳门 特区$更好的 未来
为 公元前|三十一年|南越王|赵佗 所筑造
赵佗 为|防盗兵|侵占 其 领地
许多|重要 文物$据说 已被 收藏在|英德 博物馆里了
那时|这里 曾经 是|多么地 喧闹
只有 这里的 芳草$还可以|一岁 一枯荣
对 开发 岭南|建设 岭南$是 作出了|不可 磨灭的 贡献的
芳草 下$必定 埋着|许多的 故事
晨耕 同志 就是我|赤诚 相交 几十年的$亲密 战友
从此|我 和 晨耕 同志$成了|并肩 工作的 战友
我俩 有|相同的 爱好|和 审美观
一旦 进入|创作 状态$就|不分 你我了
更是 无私的|团队 精神的 结果
舍不得 他|付出了 一生 心血的$战友 文工团|晨耕 走了
大概 是从|宋代 大诗人|陆游的 诗句$亡羊补牢|理所 宜始
但 他说 这两句话$是从 一些|老百姓 嘴里 听来的
如果 平日 对|羊圈|多 检查 检查
在 提醒 人们|羊 丢了|赶快 补圈的 同时
任重 道远$香港 第二届|行政 长官|选举 展望
参选 香港|第二届 行政 长官
一次次|热烈的 掌声$和|个界别 代表|诚挚的 发言
表达了$各界 人士|对 董建华的|殷殷 期许|与 良好 祝愿
认为 在|香港 面临|严峻 困难|和 挑战 之时
香港 许多|知名 人士|明确 表态
目前|香港 没有 比他|更合适的 人选
关乎|国家 统一|民族 振兴的|千秋 大业
已经 积累了|丰富的 治港 经验
增长了$带领 香港 开拓|更美好 前景的 才能
董建华 也没有|丝毫的 懈怠
关于 兰州|金和 集团|串通 债务 担保人$逃废|金融 债务的 调查
不仅 招致|债权 单位的|强烈 不满
被|城关 法院 拍卖的$是 一座 名为|金和 商厦的 大楼
破产 企业 通过|各种 手段|逃废 金融 债务
得知|金和 商厦|被 法院 拍卖
驳回 长城 公司$关于对|金和 商厦|优先 受偿的 申请
原本|不属于 破产 企业 财产的|金和 商厦$变成了|破产 财产
而|金融 机构的 债权|却被 悬空
面对 小康 社会|人民 群众|日益 增长的|文化 需要
很 重要的 一点是$看它的 文化 资源$文化 氛围$文化 发展 水平
综观|当今 世界的|现代化 城市
这是|城市 发展|长盛 不衰的|关键 所在
正以|空前 迅猛的 势头$席卷 全球
文化 建设 与|信息 技术$是 互相 渗透|互相 促进的
由于 空间|和 时间 距离$被|最大 限度地 压缩
面对 汹涌 而来的|全球 信息化 浪潮
以 挖掘|和 整合|历史 文化 资源$增强 文化|中心 功能为 主线
只有 随着|时代 前进$而|不断 扬弃|改造 和 更新
才能 反映|活生生的|社会 现实
建设 自然 风貌$与 城市 景观|交融 和谐的|城市 生态 环境
使人们|不仅 能看到$别具 一格的|现代化的 设施|和 建筑
据|欧阳修 所撰|新五代史|唐庄宗本 纪载
朱温|本是 黄巢 部下|大将|篡唐 自立
符道昭 等 将官|三百人 被俘
三垂 冈一诗$是 清代|著名 诗人$严遂成的 七律
中国 古人|留下了|浩如 烟海的 诗歌
李克用 从|代北 沙陀族|少数 民族中 崛起
这是|香港 特区|全国 政协 委员|首次 视察 广州
就 看到了|祖国 内地的$蓬勃 发展
就 看到了|香港 摆脱|目前 经济|困境的 希望
广州市 确定$将 南沙 建成|以港口 码头 为中心
如果 说|以前是|香港 帮 广州
那么|在 广州|迅猛 崛起的 今天
广州 也可以对|香港 经济 复苏$有所 帮助
年过 九旬的|庄世平 团长$则是 以|简洁的 语言$来 表达 感受
其次 是|英国$日本$加拿大$澳大利亚
但|在港 聘请了 一些|知名 人士$为 名誉 领事
台湾|裕隆 汽车 公司$在|拓展 市场 方面$又 开辟出 一个|新舞台
创造|产品 质量 服务|三大 领域的|差异化
推行 产品线|更新|柔性 生产 成本|合理化等 活动
经过 一座 大山|或 一家 庙宇
把 它们的|来龙 去脉$介绍 给你 听
本届 美食节$作为|澳门 旅游局$澳门 欢迎您|系列 活动 之一
陈列出|自家 最拿手的|中国菜$葡国菜$亚洲 美食$和|欧陆 名点
不少 澳门 居民$趁着 假日|一家 大小 前来$或|观赏 歌舞
除了|纷至 沓来的|应届 大学生
吴先生|一语 道出了|台湾 大学生$热衷于|报考 研究生的 原委
大学 毕业后$在|新闻 媒体|当了 五年 记者
就会 为自己的|英文 太差$感到 难过
在 名目 繁多的|报考 专业里
台湾 大硕|文化 事业 董事长$邱昌其 认为
报考|许多 学校的|不同 专业
那 多半是|大学时的$出类 拔萃者$和 一些|在职 研究生
比如|前面 提到的 那位|黄小姐
也许|以自己的 工作 经验$作为 进入|研究所的 筹码
两年 四学期$可以 得到 总共|三十万 新台币的 奖学金
一些 村民|为|扩大 甘蔗|种植 面积
竟把|七八年前 栽下的$现已 长得|很高的 林木 砍掉
每年|都 裹挟着|大量 垃圾|流入 黄河
沿岸 河道 两边$没被 雨水|冲走的 垃圾$仍|堆积 如山
我 收到 一封|莫名 其妙的|入选 通知
那 还要 我们党的$各级 组织|纪检 部门 干什么
但|这种 研讨会$中小企业|很少 有机会 参加
常见 一些 村民$为 邻居|道路 宽窄
相邻 田埂|占地 多少等|鸡毛 蒜皮 之事
遇事 跳不出|个人的 小圈子
其中 在|当阳市 邮政局 订的$三种|报纸 杂志中
她说 省邮政局$把|当阳市的 漏发了
不少 风云 人物|曾经|光芒 四射
实际 干的|却是|劳民 伤财$搞|花架子的 事
而|这些 假象$在被|戳穿 之前
缺乏 老百姓的 认可|和 支持
金杯 银杯$远离好 口碑|是|十分 危险的
而且|挫伤了 那些$踏实 干事人的|积极性
都 凝聚着|亿万 人民的|聪明 才智
宗旨 是|全心 全意|为 人民 服务
是|党的 事业|永葆 蓬勃 生机的|力量 源泉
脚踏 实地地$为 人民 群众$办实事 办好事
诚心 诚意|为 人民 群众|谋利益
从而|大大 限制了 企业|自我 发展的 主动性$和 能动性
企业 带着 镣铐|参与|国际 竞争
政府 主要 通过|搞好 宏观 调控|和|经济 调节
工人 阶级的|主人翁 地位$是从 整体上 说的
职工 择业|自主化$薪酬|合同化 之路
新的|后来的 东西$总是要|不断 代替|旧的|已有的 东西
才能|破除 陈规 陋习$和|条条 框框的 束缚
印度 对|种姓 问题的 争论|和 思考$最后 都是$无果 而终
在|印度教 团体$百般 阻挠|和 围堵下
全印度 将有|上百万 贱民|要求 改宗 佛教
贱民 和$低 种姓 群体$要想|彻底 改变 处境
豪华的 旅馆 大厅里|空空 荡荡
与|过去的 车水 马龙|拥挤 不堪$形成了|鲜明 对照
好莱坞的|环球 影城$过去 也是|门庭 若市
不少 导演|和 演员|一度 离开了 影棚
去年的 俄罗斯|过得 确实|不 平凡
恐怕|当数 打捞|库尔斯克号 核潜艇了
巨大的 爆炸$使 船头 部分|严重 损坏
俄罗斯|含悲 忍痛$执意 打捞|库尔斯克号
给|所有 遇难|官兵 家属$一个|明确 说法
库艇 打捞 工作|暂时|告一 段落
和 蒙古 朋友|约好了|见面 时间
蒙古人|常挂 嘴边的 两个字|就是 明天
阿根廷的|这项 指数$突破了|百点 大关
居民 家家户户|自发|挂起 国旗
在|朝鲜 南浦市 港口区|后浦洞$一座|精巧 别致的|两层 小楼里
四 胞胎|五个月 出院时$体重|都 超过了 十公斤
总计 相当于 朝鲜|一个 普通 工人|一年的 工资
朝鲜党|和 政府$为 他们|专门 提供了 一辆|牛奶 供应车
朝鲜|全国 各地$为 四胞胎 送来了|玩具 童装 等物品
国家 还为 四胞胎$拨 专款|修建了|一百多 平方米的$两层|高级 住宅
我 这个|平凡的 工人$没有为 国家|做过 什么 大事
四胞胎 在|今年 一月的 同一天$穿上了 军装
中小企业 来华|洽谈 投资$也 形成 热潮
韩国的 中国热$已经 渗透到|社会 上的|方方 面面
就连|大街上 张贴的 广告|和 商店的 招牌$有的 也用|中文 书写
已 成为 一项$深受|象棋 爱好者 欢迎的|传统 赛事
马晓春 九段的 妖刀|今日 变成 钝刀
这盘 比赛|双方 前手$和 前一盘|一模 一样
认为 黑棋是|占 小便宜|吃 大亏
此后 马晓春$鬼使 神差|连出 缓手
马名人|以往的 锐气 灵气|全然 不见
比 常昊|大出 整整 一轮的 马晓春$拿了|三届 名人
但 两队|本轮 相遇$仍 拼得|鱼死 网破
江苏 女排|主场 胜|云南 女排
进行|第二 阶段|主客场 双循环赛
在|全省 开展|严厉 打击$盗抢 机动车|犯罪 斗争
派 民警|身背|机动车 表格|和 号码
有的|简陋 而|不能 满足|办公 需要
河南省|第一 监狱 干警|王红松$为 解救|被|罪犯 劫持的 人质
记者 彭俊$从 日前 结束的|全国 农业|援藏 工作|座谈会上 获悉
对口 支援 西藏的|五个 省市的|农业 部门$继续 加大|援藏 力度
有|很强的 针对性$和 鲜明的|可操作性
今年 在苏联|伊尔库斯克 大门 金厂$任|工人 指导员
省内 旅客 运输$含|水上 漂流
航运 公司$失去了 茅岩河|漂流 经营权
湖南省|高级 人民法院 认为$原审 认定|事实 不当
永定区 人民政府|自行 撤销了 纪要
茅岩河 漂流|不允许|多家 经营
是 因为|河流 湍急$滩礁多$河道窄$资源 容量 有限
充分 肯定了|去年的|妇联 工作
会议 认真 学习了|中央|书记处的 意见
妇联 是|党领导的 重要的|群众 组织
把 广大 妇女|紧紧地 团结在|党的 周围
交通 部门|及|交警 乱执法$滥执法 现象|时有 发生
农用 拖拉机|和|农用 运输车|属于|农业 机械
有的 委员|赞成|草案中的 规定
日本 海上 保安厅$在 东海 海域$追逐 一|不明 国籍的|可疑 船只
日本 媒体|大肆 渲染|日本 在 海洋上|面临的 危险
海上 保安厅 行动$有 违反 联合国|海洋法 公约的 嫌疑
就|认定 该船 可疑$并 对其|紧追的 理由|是 不充分的
是否 尊重|中国 在|该海域的 主权|与 尊严
不明 船只|开枪 还击$是 沉没前|两分钟|才 开始的
我们 就对|这种 行为$进行了 谴责
以向 他人|支付 佣金 等方式|招揽 业务
对于 支付给|会计师 事务所的 报酬
办事 机构 账户|除 母企业的|拨款 款项外
母企业的|拨款 款项$仅限于 该办事机构|合理的 办公 经费
严防 公路 三乱$乱设卡$乱收费$乱罚款
这个 时期 往往是|公路 三乱的|易发期|和 高发期
对 运输|蔬菜 瓜果等|鲜活 产品的 车辆$不管是|哪个省的 牌照
严重 违章的 纠正后$可通知|车辆 所属地 处理
还清 贷款后|不能|及时 撤站
任何 一方的 决定$即 当然地|代表 双方的|共同 意思 表示
关于|夫妻 一方的|婚前 财产$为|个人 财产的 规定
如果|不提出 离婚 请求$或者 人民法院|依法 判决|不准 离婚的
无权 提出|此类 损害|赔偿 请求$或其 请求|不能 得到 支持
该局 采取|多项 措施$压缩|运输 成本
拆除 旧房 面积$和|动迁 居民户$比 去年 增长了
以便 尽可能地|贴近 当地|百姓 生活
坚持 学习|科学 文化$与 加强|思想 修养的 统一
同学们 经过|十多年|寒窗 苦读
粮食|流通 体制 改革|正向|纵深 发展
今年 由于|粮食 流通 体制$和|粮食 购销 格局|出现了|新的 变化
可以|优先 发放 贷款|予以 支持
农发行 将|按照 积极|和 审慎的 原则$给予 贷款 支持
直接 深入到|一些 村站所$和 领导 干部 联系点|进行|督促 检查
主要 应让|干部 受到|三个 代表|重要 思想的 教育
要|加强 对|学习 教育|活动的 督查
参加 投票的|俄国家 杜马$十位 议员中
吴仪|详细 询问了|设备 使用 情况
国务院|有关 部门 负责人|牟新生$马秀红等|陪同 考察
纵横 交错的|信息 网络$为这片 红土地|带来|新的 希望
老农的|粗大 手指$灵活地 敲击 键盘$信息化的 生命力|是 应用
出纳员 陈光大$正在向 电脑 输入|当日 上午的 账单
三十岁的 会计|梁乃海$在 另一台 电脑上$核对 网上的|每一组 数据
南海市|信息化的 着眼点$不是 建硅谷
虚拟 链接 信息化$带动 小企业|全面 升级
常常 派人 到外地$把别人的 面料$带回来|人工 仿制
因为|各家 各户|分散 经营的 小厂$适应 市场|能力强
越来 越多的 企业|尝到了|信息化的 甜头
他们|伸手 在 柜台上|取 一张表
在|触摸式 电脑上$查一查 有关|法律 和 指南
通过|信息 系统$将政府的|决策 运作 过程 公开
中国 电子 政务|应用 示范 工程|总体组的 专家$对 记者说
以|信息化 推动|率先 基本 实现|社会主义 现代化
许多|卓有 成效的|应用 系统
都是|各企事业 单位|自己 主动搞的
以 电子 政务|为 代表的|网络$逐步 铺开
形成|纵横 数字化|网络化的 系统
一个|信息化 社会的 雏形$正在|南海市 形成
检察|宣传 工作$要|与时 俱进
营造|检察 机关|积极 进取$公正 执法$昂扬 向上的 氛围
司法 行政|宣传 工作$将紧紧 围绕|总体 要求$和|实际 工作 展开
首先 应|更新|法学 教育的|思想 与 观念
以及 懂法律$懂外语$懂经济 贸易的|高 素质的|复合型 人才
民营企业|上市的 门槛$将真正 降低
我们 有|好多 民营 企业$最后 垮掉
对|多边 贸易|协定 义务的 遵守
有|强烈的 好奇心|和 模仿力
我国 新的 法官法|和 检察官法$正式 出台了
对于 塑造 司法的|品格 和|尊严$尤为 重要
对于|克服 目前|司法 尊严的|某些 缺失
实质 是一种|司法官 尊严|集合体的 实现
参加 此次|价格 听证会的$国家 计委|李德昆 司长 认为
价格 决策 听证风$吹遍了|广东 各地
并把 它们 列为|下半年 整顿的|重点 对象
收购 单位|压级 压价|多扣 水分|和 杂质$少付 农民 价款的
世界 银行|七月 一日 发布的$题为 中国
中国的 环境 保护$虽取得了|很大 成绩
建立 有力的|环境法的 主体
最高 人民检察院|副检察长|赵登举 强调
随着 一些|非公有制 经济成份的 发展
工会法 补充了|劳动法中$有关|劳动 合同的 规定
它的 出台 过程$是 严谨|而 周密的
如何 处理好|定与变的 关系
但 由于|所送 商品的|品名 和 数量$甚至 质量|都是 模糊的
采取|价外 馈赠 方式|销售 商品$和 提供 服务时
禁止 一切|破坏 植被的 活动
在|投资 阶段|免征|各种 税收
作为 奉献给 大家的|一份|回首 九八年$相约 九八年的|新年 礼物
全方位$多角度$深层次地|报道 我国|民主 和|法制 建设的 进程
我们|力争 为读者 奉上|更精彩的 内容$更新颖的 版面
探讨|人大 工作 面临的|新情况$新问题
为您 提供|更多的$法律 信息|和 法律 帮助
监督 广角|民主 之路$监督 热线$多棱镜$目击者$民主 评说
纸币 用的 纸|和 印刷 油墨$都是 特制的
如 纸币的|手感 水印 等$是为|公众 判断|真伪 设计的
其|商品 贸易$已占|全球 贸易 总额的$百分之三十 以上
并 促成|公正 合理的$国际 经济 贸易|新秩序的 建立
促进|世界 经济|和 贸易的|协调 发展
石油 价格|暴涨后$接着 暴跌
墨西哥 挪威等|非欧佩克 产油国$也将 按照|各自的 承诺
这将为 产油国|实现|限产 保价$铺平 道路
著名 老将|水庆霞$担任 助理 教练
实现|金牌 零的 突破$难度 要|大于 上届 冬奥会
盐湖城的|气候 条件|雪质$有 很大 差别
中国 冰雪 健儿|三日内$将|陆续 奔赴|美国 和 欧洲
北京|奥运会 组委会$由|三类 机构 组成
为 利用|奥运会的 东风$促进 北京的|城市 发展
选出|正确 答卷$四千 五百|二十四份
众多的 科学家|和 艺术家$称赞 它是$科学|与 艺术的$完美 融合
丹凤县 政府$因|环境 污染 损害|获 赔偿
胡宝林|私自 雇用$无|运输 危险品 资格的|邓小琦$拉运 氰化钠
胡宝林$邓小琦$张国井$扬品生$被判处|有期 徒刑
今冬 明春的|三下乡 活动$风潮 正涌
被|农民 誉为$播撒 致富的 良种
这种|让农民 觉得|实用 实惠的 节目|播出后$引起|强烈 反响
以及|商住 分离$动静 分开$人车 分流的$明确 功能区 划分等
每人|编取 法号$用钳子 拔掉 头发$形成|圆点状的 戒疤
江苏省 靖江市|孤山镇|机关 干部|深入 农户
新疆 鄯善县$生态 环境 脆弱
已 开发 种植|十个 品种|近 千亩的|鲜食 葡萄$和 其它|示范 作物
四十辆 满载|脏衣 旧物的|大卡车$驶往 城外
追缴 洋垃圾|取得的|又一 战果
有人 用 暴力|强迫他 购买|洋垃圾
肮脏|散发着 异味的 衣物$被|熨烫 平整
廊坊市 广阳区|新开路 街道|康乐 社区
朔州市 朔城区$平朔 煤炭|工业 公司 社区
包头市$昆都仑区|阿尔丁 街道$乌兰 社区
沈阳市 和平区$南湖 街道|文安路 社区
本溪市 溪湖区$彩屯 街道|彩玉 社区
四平市 铁东区$四马路 街道$东星 社区
牡丹江市 西安区$牡丹 朝鲜族 街道$第三 社区
曲阳路 社区$闸北区|临汾路 社区
苏州市 金阊区$三元 街道$三元 一村 社区
无锡市 南长区$清扬 街道$沁园 新村|第一 社区
经常是|负债 累累|贫困 交加
对 文物 保护中|许多 重要的 环节$都作了|明确 细致的 规定
馆际的|有偿 转让 问题$并不是|主要 矛盾
华盛顿 时报|上述 报道|纯属$别有 用心
美 国内 个别人$企图|以此 诋毁|中国 形象
中国 读者|也许对|华盛顿 时报 不熟悉
甚至|将它 和|华盛顿 邮报|混为 一谈
公开 批评|布什 政府$未出售 宙斯盾舰|给 台湾
强烈 驳斥$来自|美国的 谣言
经常|抖出 一些|反华 包袱$哗众 取宠
台湾 领导人|陈水扁$六月 八日$接受了 他的 专访
以色列|应当 放弃 敌视|阿拉法特的 政策
以色列的|上述 政策$是 愚蠢的 政策
唐家璇|当天 拜会了|约旦 国王|阿卜杜拉
约旦 首相|兼国防 大臣|拉吉卜$和 外交 大臣|哈提卜$陪同 会见
中约 两国|友好 合作 关系$将会在 新世纪$得到|进一步 发展
在这个|西南 地区|最大的 水果 市场内
根本 不清楚$其|特殊的 内涵|和|证明 商标的 专有性
坤源牌 西瓜$鳌福牌 茶叶 等等
农民 种韭菜$严格 按|要求 生产
几万个|诗文 词曲|辞赋 名句
那些|手拿 羊铲$哼着 信天游的|放羊人
将改|千百年来的|传统 放牧$为 用羊舍 养羊
养羊|并没 让|太多 农民$富裕 起来
他们 花|数千元|购买了|良种 种羊
一只 羊的|纯收入$可达|三百元 左右
除 不可抗力$对方 违约$及|双方 当事人|协商|依法 变更 解除外
培养 大批|懂业务|会管理$熟悉 法律$和|国际 规则的|专利 人才
查处 假冒|他人 专利$和 冒充|专利 案件
黄帝陵 整修|二期 工程|二十五日 动工
今年|进一步 采取|共同 集资$拼盘 办事的 做法
全省 在|去年 新增|三十三个乡$通了|公路的 基础上
防止 和|克服|虚报$瞒报$迟报$漏报 现象的 发生
进一步 摸清 我国|各类|基本 单位的 数量
要|最大 限度地 衔接|和 统一$单位 认定的|标准 和 代码
必须 下|大力气 整顿好|市场 经济 秩序
而 主要 要靠|全面 改善|投资 环境
陈至立$项怀诚$高强$张志刚$廖晓淇$马秀红等
正泰 刚刚在|欧洲 中标 一项$五千万 欧元的|电器 工程
集团 三座|现代化 厂房$崛起在|温州 市郊|乐清柳市
只是 一个|家庭|作坊式的 小企业
绝大 部分|从|八十年代 初期的|家庭 作坊 起步
全省|百分之 九十三的 企业$完成 改制
百分之 八十四的 企业$建立了|新型 劳动 关系
全省|盈利 最大的|前十家 企业中$有 六家|国有 企业
地处$太湖 之滨的|湖州市 织里镇
浙江的 工业$正处在|从 量的 扩张$向|质的 提高的|嬗变 之中
绍兴县 柯桥|轻纺 市场$几年来的|惊人 跳跃
堪称|浙江 工业 结构|优化 升级的 缩影
县委 县政府$着眼|长远 竞争 需要
绍兴|花 巨资$引进 国际上|最先进的|无梭 织机
使|全县 纺织业|无梭化率 达到
浙江 出台|财政 贴息 等|一系列 优惠 政策
正在 从|小企业$小产品$小规模
一批|称雄 同业的|企业 小型 巨人$已经 展露 风采
在 巴西$南非$阿联酋 等国$建立了|三家 市场
那么|别的 省区$也|一定 能够 建成|秀丽的|绿色 山川
遇到 天旱$连 一斗|也 打不下
陕西|是 我国|水土 流失|比较 严重的 省份
把 国家 补助$不折 不扣地$兑现到|退耕户 手中
十亿元的|五个 种苗 基地$绝大 部分|已经 竣工
国家 又给 陕西|退耕 还林|和|荒山 造林 任务$一百 多万亩
以 面对|经济 全球化$犯罪 科技化$知识 密集化的 挑战
并 适当 考虑$与|国际 法律|服务 市场的 融合
中国|有过 两次|法律 变革 浪潮
与|黑恶 势力的 斗争$正 未有 穷期
严重 扰乱|正常的|社会 生活 秩序
有的 政府机关|个别 腐败分子$甚至 雇佣|犯罪 团伙 成员
辽宁 沈阳市|黑社会 性质$犯罪 组织的 老大$刘涌的 身后
这个 披着|市人大 代表 外衣的|黑道 霸主$有直接的 保护伞
原 沈阳市|人民检察院 检察长 刘实$是|刘涌的 干爹
要 继续 深化$打黑 除恶|专项 斗争
我们 只有|深挖其 存在的 根源$并|对症 下药
才有 可能 让|黑恶势力$失去|生存的 土壤
实施|商品 质量|监督 抽查 制度
中央电视台|今日说法 栏目$不久前|进行的 一次|网上 调查
今天|本版 试图从|多角度$对这 十大 话题|作一些 说明|和 解释
修改后的 婚姻法$是在|十年 婚姻法的 基础上
因 重婚|或 有配偶者|与 他人 同居$导致 离婚的
居民委员会$村民委员会$以及 所在 单位$应当 予以|劝阻 调解
有的人 渲染|性自由|性解放
有的人 包二奶|养情人 纳妾
全国人大常委会$将 婚姻法|修改 草案$向|社会 公布
为了|方便 广大|读者的 阅读
促进 海域的|合理 开发$和|可持续 利用
为了|妥善 处理|电信 网间|互联 争议
为 促进|证券 市场的|健康 发展
在同|个体 船舶|所有人|平等 协商的 基础上
采取|收购 折价|入股 等方式$吸收|个体 经营户的|运输 船舶
进口 产品|以倾销 方式|进入 中国
倾销|和 反倾销$将是|围绕 中国 企业的$一个 大问题
无疑 会留下|重重的 一笔
股市 暴涨 带来的|财富梦$也|彻底 破灭
今年|西方 国家|股市的 特点$不仅是|下跌 幅度大
美欧日 三大 市场|无一 例外
道琼斯指数$一度 下跌了|三百 多点
英国 金融时报 指数$一度 也曾从|今年的|最高位 下跌
日经指数$在 事件后|曾 跌到了|三年来的 最低点
日经指数|则 苦苦 挣扎在|万点 大关线上
欧美 股市的|暴跌$使|消费 信心|受到 重挫
包括了|亚洲 三个|信息 技术|公司 股价
无疑 会在|很大 程度上$依赖于|美国 经济的 复苏
有 最准确的|经济 预测 专家 之称的|佛丝勒 认为
世界 经济 从|去年的 强势|转为 颓势
作为|经济 晴雨表的|全球 股市$连锁性 狂跌
事件 使|世界 经济 濒临|衰退的 冬天
世界 经济的|火车头 美国$经济 不断 下滑$并|率先 进入 衰退
各国|纷纷 采取 措施$反恐怖$反衰退
加上|早些 时候的|宏观 经济|刺激 措施
这 增强了|国际 金融的|均衡性
包括 美国$反恐 战争的|进展 所影响
篮球 杂志$自 一九八一年|创刊 以来
战胜了|重庆 宗申队$八十公斤 以上级的 杨晓靖
他在|冠军 决赛|首局 比赛中
遗憾地 与|散打王 称号|擦肩 而过
散打王 获得者$可获|十万元 人民币
中国 篮球 选手|王治郅$和|达拉斯 小牛队|正式 签约
比利时人 罗格|接替 萨马兰奇$成为 国际奥委会|第八任 主席
荷兰等|世界 老牌 强队$在|预选 赛中|遭 淘汰
在 澳大利亚|举办了 第五届|友好 运动会
由 全国人大 常委会|副委员长 邹家华$任 编委会|名誉 主任
该 大典|集中 反映了 我国|当代 机械设计的$最高 水平
手捧 一卷|飘逸的 毛笔字|写就的 子夜
影印版 茅盾 手迹$分|上下 两函
他 精通|唢呐$顿流$镇撤等|各种 演奏 技巧
要 按照 规定$及时 移送|公安|司法 部门 处理
找谁|该怎么办$该收|多少 费用
留美 硕士$北京|伯聪 信息技术 有限公司|总经理 薛军
原以为 需要|一两个月|才能 办妥|公司 开业|所有 手续
扣发|直接 责任人|三个月的 奖金
追究|有关 领导|管理 不严的 责任
将|上万名 职工的|基本 生活 保障$向|失业 保险 并轨
辽阳市 确立了|兼顾|国家 企业|和 职工|三者 利益
逐步 完善|平稳 过渡的 原则
从|各个 渠道|筹措 资金$支付|下岗 职工的 补偿金|和 补助费
本报|地方 新闻版$刊登了|明月 蒙灰 何时净
反映了|梁平县 劣质 煤炭|土法 锻烧 石灰$污染 明月湖
立即 成立了|石灰 土窑|整治 取缔|领导 小组
荆门市|投资 项目 收费额$占|工程 投资额的 比例$已降至 百分之十 以内
在 厦门市|喜迎 特区|建设 十周年 举办的$百年|厦门 摄影展上
参观者|不时 发出|由衷的 赞叹|和 感慨
厦门|一定会 成为|东南 沿海$一颗|璀璨的 明珠
就在|贫困的 新生$抱怨|学生 公寓|收费 太贵的 同时
另外 一种 情形$也在|高校 出现了
以|百折 不挠|和|无私 奉献的 一生
和 该船|在中国 专属 经济区内|沉没的 事件$表示了|严重 关切
总额 为|二十六点 三亿 美元
日本 财务 省次官|黑田东彦 说
交火 主要 发生在|克什米尔 查谟 地区的$蓬奇 地段
本报 伊斯兰堡|六月一日电$记者|丁子 报道
但 目前的|紧张 局面$并非|无法 挽救
四名|基地 成员|被 移交|阿 临时 政府
用|鲜活 柏树枝|作 燃料$熏制|香肠 和 腊肉
一些 商家|舍近 求远$来此 组织 货源
不法 之徒|把 柏树$当成了|赚钱 筹码
大量 使用|鲜活 柏树枝|熏制 香肠|和 腊肉
不文明的|传统 习俗$也该 改改了
台北|国父 纪念馆 馆长|张瑞滨 表示
而|火烧 圆明园等|历史 事件
国家 计委|从 两千年 开始|组织 撰写的
聂荣臻 同志$为|正在 撰写中的|李富春传 作序
来自|五大洲的 礼品$琳琅 满目
晶莹 剔透|熠熠 生辉的|水晶 玻璃
非洲的 雕像$美洲的|古代 岩画 临摹$大洋洲的 银袋鼠
文化部 部长|孙家正$为|中国 国家|话剧院 揭牌
剧院 上演了|众多|中外 戏剧 名作
并 推出 自己|精心 创作的|新剧目$大炎热|新闻 热线等
记者 徐运平$从 今天 举行的|全国 检察长|工作 会议上 获悉
给 一批|黑恶 势力$以|毁灭性 打击
对 注册 会计师$出具 审计 意见|监管 更严格
或者 以|保留 意见|代替$否定 意见
根绝|开垦 草原|带来的|生态 问题
已 引进 博士生|二十多名$硕士 研究生|三十多名
首都 博物馆|藏品|十分 丰富
许昌|外向型 经济|跃上 新台阶
全省 工业|盈亏 相抵后$累计|实现 利润
不仅 在|唱腔的|艺术 处理上
充分 运用了|自己 对|声腔 造型 艺术$多年 研究的 成果
气急|而 无奈地|大动作 跺脚
当|压抑中的 金子$与|仇虎 重逢时
激情 奔放地|跳到|仇虎 身上|捶打 拥抱
将|金子 心中|多年 积蓄的$对|仇虎的 爱$全部|释放 出来
金子 两次|力度 强弱|对比 鲜明地$提起 焦大星
集中 表露了|金子 对|大星 满腔的$爱怜 恨怨
重视|细节处的|戏曲化 表演
她的 遭遇$更加 引起了|观众的 牵挂
沈铁梅的 演唱$注重 对|人物 心灵|深入 细腻的$逐层 开掘
沈铁梅 演唱的 那段|清炖 鸡腿$咬起来 香
表露了 金子|心如 止水般的 愁思
她那 具有|穿透力的 嗓音$搅拌着|哀爱 痛叹 愁忧的|种种 情绪
通过 她的|天赋 歌喉$演唱 出来
沈铁梅 在|十几年前 就有|川剧 唱腔|女状元的 美誉
到 当年|智能 不凡的|少年班
再到 如今|小鬼 当家的 文坛
而|中国 教育 电视台|报道的|某位 女孩$就|更是 了不得
俨然 已 呈现出|小鬼 当家的 格局
六七岁|能与 财主|奸商 斗智
八九岁|可与 文人 雅士|掰腕 等等
就是 这些|神乎 其神的 神童
爱迪生|甚至 被 视为|脑袋 迟钝的 低能儿
还真 与其|童年的 神与 不神$没有 太大的 关系
我们 也应当|正确 看待$天分|和 聪明
起码|不至于 落个|泯然 众人的 结局
写作 是一种|厚积 薄发的 行为
被 当地|强迫 演了 五场$才|放 他们 走
实践 这个|方针的 成就$是 巨大的
完全 没有 削弱$或者|歪曲 原著
我们|特邀请 戏曲界|专家 学者$就此|撰文 评价
每人|手持 一个|放有|各种 类型|电话卡的 夹子
行人 上路$耕牛 占道|车辆 抢行|等 现象$非常 严重
不做 损坏|防护 栅栏的 事情
老两口|辛辛 苦苦$拉扯大|三儿 三女
勒紧 裤带$为 儿女 办完了|婚嫁 大事后$和 小儿子|生活 在一起
大姨|四十五岁的 时候|生病|瘫在了 床上
大姨父|也 腰腿 不灵|干不动 活了
只有|步履 蹒跚的 大姨父$照料着 生活|不能 自理的 大姨
我的 二姨|和 二姨父$也 六十岁了
小儿子|干脆 在|责任田里 盖房
两位 老人|住在 老宅院内$仅留下的 一间|茅草 房里
在 打闹中|分家$因|赡养 老人 而|兄弟 不和的$比比 皆是
儿女的 孝心|依赖的 是|道德的 保障
譬如|百强 企业|金牌 产品$重点 期刊等
但 对于|类似 卫生|先进 单位$百强 企业等|时效性 奖牌
体现在|保护 和|改善 生态 环境$建设|秀美 山川的|具体 实践中
以 盲目 搞小|而|全低 水平|重复 建设的|经济 增长 模式
但|呼吸的 空气|是 不新鲜的$喝的水|是 不干净的
单纯的 经济 增长|不等于 发展
全面 加大 推进|治污 进程的 力度
也许 有|很多人|没有 见过|林巧稚 大夫
我们|会从 她 朴实的|深刻 而|睿智的 医学 思想中
捕捉到 她|伟大 精神的 闪光
她对 病人|极端 热忱$极端 负责
从为 病人|擦 汗水$掖 被角$到 解决 各种|疑难 问题
其 责任$已经|丢掉了 一大半
她 要求|临床 医生|永远 走到$病人 身边去
要到|病人 床边$去做|面对面的 工作
但它 不能|完全 代替|医生 对 病人的|直接的 工作
不仅 要从$党政 机关|挑选|后备 人选
结合|领导 班子 换届$和|届中 考察|年度 考核
我们 队伍中的|一些 同志$恰恰 在|这一 点上|出了 问题
或者 淡忘$甚至|丢掉 艰苦 奋斗的|好传统 好作风
沉溺于|纸醉 金迷$腐朽 糜烂的|生活 方式
不仅 损害|党同 人民群众的|血肉 联系
削弱 党的|凝聚力|和 战斗力
抵御 各种|腐朽 思想|侵蚀的 难度 更大
而且 对|白棋 形成了$反 包围
今天 在|此间 举行的|赛前 动员会上
但|中国 冰雪 运动$艰苦 努力 得来的|显著 进步$却|有目 共睹
夺得 冠军的 几率$大大 超过 以往
此次|中国 代表团|将 面对的 挑战$也比 以往|更为 严峻
上届的 名将们$大多|宝刀 未老
第十九届|冬奥会的 赛场$地处 高原
安南 秘书长$又|重新 任命了|阿富汗 问题|特别 代表
联合国|主持了 在|波恩 召开的$阿|四方 会议
其中|贫困 地区 冲突$宗教 和|种族 偏见等$是 最主要的
对|遇难者 家属$表示|沉痛 哀悼
江主席$除|多次 与|布什 总统|互通 电话外
中国|反对 在|反恐 问题上$搞|双重 标准
反对 将 恐怖主义$与|特定的 宗教|或 民族 挂钩
布莱尔 开展了|举世 注目的|旋风式 外交
阿拉伯 国家|和|伊斯兰 国家$谴责|恐怖 袭击 事件
主张 必须|追捕 事件的|制造者
巴基斯坦|在 事件后|审时 度势
加入了 打击|恐怖 主义的 阵营
阿富汗|塔利班 政权$已经 垮台
该县 服务团$共为 农民|提供 服务|三万余 人次
专家们|每隔 数月$就|调低 一次|经济 预测
香港特区政府|经济 顾问$邓广尧 指出
昔日 亚洲|四小龙中的|另外 三龙$新加坡$韩国|和 台湾
致力|吸引 内地 金融|和 资讯 科技|专才 南下
目前 已经 入港的|专才$最高 月薪|达到|十万 港元
香港特区|财政司 司长|梁锦松 指出
粤港|高层 人士 之间的|互动$是 历年来|最频繁的
目前|香港 经济|出现 衰退|是 短暂的
中国 长城|资产 管理 公司$资产 拍卖周$共 成交 项目|一百二十个
说|您认为 中国的|证券 市场$不该有|中国 特色
结果$被 演绎成|别的 意思了
这个 产品的|素质 高低$将|直接 影响到|市场的 发展
市场|永远 走在|监管者的 前面
在|关联 交易|利益 有冲突时$用 条例|来 规范|公司 行为
它将 有助于|减少 公司 董事会$和 管理层的|违规 空间
证券 市场$在|优化 资源|配置 方面$功能 发挥的|不很 理想
省委 常委|省委 宣传部 部长|张保庆 号召
陕西 省委|十分 重视$人民日报 等|党报 党刊的$发行 工作
草案 经过|反复 酝酿|和 修改
现年|七十一岁的 伊盖$是|奥巴桑乔 总统的 密友
阿伊社 援引|不愿意 暴露|身份的 人士的 话说
巴黎的|大街 小巷$店铺 橱窗
品尝 大餐$赠送 礼物$唱歌 跳舞$尽情 欢乐
今年的 圣诞节$正逢|欧元 即将 流通
一位 店员$对 未来|充满 憧憬地|对 记者说
圣诞节的 购物额$不仅 不会比|销售 情况|最好的 去年 减少
总有 一种|说不出的 别扭|和 忧虑
中东|形势 严峻$所有 这些|都使 人们 觉得
两张 照片|将|永载 史册
一是|纽约 世贸大厦|两座 高楼的 倒塌$给 世人|造成的 悲痛
唐家璇 当天 还同|叙|副总理 兼 外长|沙雷$举行了 会谈
由于|使馆 设施|遭到|严重 破坏
到 加油站|加 十升 柴油$居然 少了 一升
但|标准 与|现实间$竟差 许多倍
这种 改变|机器 设置$再 减少|出油量的|偷油 方式
这些 贺卡$多画有|阴森的 城堡
是不是 活得|不耐烦了 等等
不用|文明 健康的 方式$引导 孩子
被 深圳|妈湾 电力 有限公司$以 七百 万元|成功 竞买
海口市|有 各类|停缓建 工程 十多个
规模大$功能杂$成本高$产权 不清
减免 税费$和|欠税 挂账|一亿 多元
另有 一宗|十公顷|闲置 土地$将|限期 开发
全国|约有 万人$从事|企业 法律|事务 工作
自 二零零一年|一月 一日起$暂在 上市的|金融 企业|范围内 实施
二是|深化 黑心棉|专项 打假 战役
八是|组织 锅容 管特|专项 打假 战役
全省|国有 及|国有 控股 工业企业$实现 利润
邯钢 领导班子$跳出 邯钢|看 邯钢
为 邯钢|进一步 理清|加快 发展的 新思路
被 称为 我国$玻璃 工业 摇篮的|耀华 集团
以上 涉及到|理顺|资产 关系$完善|母子 公司|管理 体制的 问题
在|认真 剖析|原因的 基础上
在|中层 管理 人员中$实行|公开 选拔$和|竞聘 上岗 制度
提高了 党组织的|凝聚力 和|战斗力
但|田家庵区 区委的|几个 会议室里$却是 一派|热气 腾腾
正在 角逐|三个 社区 居委会|工作 人员的 岗位
特别是|公民 道德 建设|实施 纲要的 颁布
反映|当代 大学生$生活 理想 追求的$无场次 话剧|同桌的 你
还有$以|破除 迷信|反对 邪教|为主要 内容的|邪教 警示录 等
其中|无话 可说$还 荣获了|剧本 创作 最高奖|曹禺 文学奖
如|四姑娘 死水 微澜$山杠爷 变脸等
不只 是指|川剧$有许多|表演 技巧|和 特技
他们 除了|注意 对|原著 思想 意蕴的|开掘 等
敢哭|敢笑|敢说|敢做|敢抗命
在|铿锵的 节奏中$表现出|人物 种种|欲罢 不能的 情感
又一次 荣登$优秀 剧目的 榜首
使 金子|始终 处于|全剧的|矛盾 漩涡 之中
自己的 丈夫$和|过去的 恋人|时时 都在$翻搅着 她的 心
使用|粗犷 豪爽的 动作$表现|金子的 大胆|和 野性
却以|少女般的 柔情$投入|仇虎的 怀抱
而 金子|恨 阎王婆 焦母$又是|那样的 切齿
恨|丈夫的 软弱$又是|那样的 痛心
可以 说是|又麻$又辣|又烫的 金子
由于 这些$都市 村庄的|商业 服务业$房屋 租赁业 等|迅猛 发展
不仅 使|超生 现象|得到 控制
过去 干什么事$都得 跑$很远 去办
仅来自|灌南县 响水县的 黑车$就有 十多辆
不在|核定的 客运站|停靠 上下 旅客的
由|丧葬 引发的 各种|迷信 活动$及|腐败 现象$也 不少见
我国|殡葬 改革的|总方针 是
现在|虽然 有了|殡葬 管理 条例
报刊上 鲜有$殡改 方面的 文章
许多|西部 省区$连|像样的 殡仪馆|都没 几个
多建些|设备 较先进的|殡仪馆
有些 地方|殡改 工作|难 推动
有的 地方|公开 实行$只要 交罚款$就|允许 土葬的 办法
而是 要在|进一步|完善|殡改 制度的 同时
而是|找了 一些$没有 技术 资质的|当地 农民|来 施工
有的 农民 仅用|石灰渣 固基
这条 便道上|大坑 小坑$接连 不断
人们 走|这条路$也得|穿上 雨鞋
明年 将对|奥运 设施 规划$进行|必要 调整
这些 标准$填补了 我国|室内|环境 领域的 空白
公说 公有理$婆说 婆有理的 扯皮$将|成为 过去
这|一系列 官司$经|媒体 报道后
加之|建材 装修|和|家具 市场|鱼龙 混杂
室内 空气|污染 问题$不可 避免地 产生了
布艺 沙发 喷胶$带来|苯 污染
这种 物质$对|人体 健康的 损害$不可 忽视
但|总体上 来说$相关的 知识|知之 甚少
只有从|最大 多数人|最 紧要$最 迫切的 事情 做起
由于|生产力 发展 水平$资源 禀赋|基础 设施 等|方面的 差异
深入 持久地 开展|创新 创业$创文明的 活动
必须 坚持|重点论 和|两点论的$辩证 统一
先从|关系 全局的|事情 抓起
把|办点 示范$与|推动 全盘|结合 起来
必须 坚持$过程论 与|阶段论的$辩证 统一
不实现|阶段性 目标$不松手
提高|民族 自尊心$自信心$和|自豪感
亿万 人民|在|党中央 领导下$告别了|困扰 多年的|短缺 经济
世界的 发展$也|离不开 中国
社会主义|在 我国的|巩固|和 发展
以|臧如意 为首的|北京 代表队|连战 皆捷
你 何日|捅破 窗户纸
第五届 三星杯|世界 围棋赛$日前 在|上海 落幕
但他|决赛中的 对手|曹薰铉$却|体会 颇深
常昊的|心理 驾驭 能力$还 差一点
中国 棋院|副院长 王汝南$感慨 地说
但|有一半的 冠军 头衔$为|李昌镐 独有
恐怕|取胜的 机率|就会 增大
常昊 在与|曹薰铉$争夺 三星杯|世界 围棋赛|冠军 之前 曾说
我与 曹老师|对垒的|最大 优势$便是|比他 年轻|
三十岁的 曹薰铉$最终|战胜 常昊
新锐 棋手|虽然 夺走了|马晓春的$一个个 头衔
但 他们|还|远未 达到$马晓春的 境界
诺贝尔奖$已|整整 走过了|一个 世纪
俄国人 齐奥尔 科夫斯基$提出了|宇宙 航行 理论
美国人 汤斯$则 成为|激光器 发明者 之一
人们 应该|永远 记住$为 科学的 发展|建立 勋业的|科学家们
德国的 普朗克$提出了|量子的 概念
他在 一九九八年$提出了|狭义 相对论$并在 年内$完成了|广义 相对论
人们|也 应该 记住|海森堡 狄拉克
李政道$杨振宁$丁肇中$朱棣文$崔琦$以及 李远哲
哪一样|不是 与|物理学的 发展|紧密 相联
尤其 是 作为|南共市 灵魂的|共同 对外 关税$面临 瓦解的 危险
因而|国间 贸易 摩擦|不断的 现象$仍将|持续 下去
它将|仍以 一个|重要 地区 集团的 方式$参与|世界 经济
也是|市委 书记|肖志恒的 驻点村
市委 副书记|叶月坚$下到 龙门县|蓝田 瑶族乡 小洞村
各届 展会|参展 企业的|平均 成交率
广东省 茂名市$人均 绿地 面积|高达 百分之三十
市区内|花艳 地绿|水碧 天蓝
驳斥 美报$诬指 中国 向|基地 组织|提供 武器的 报道
人民日报 发行 任务$要 努力 做到|稳中 有升
必须 突出 和|确保 完成|中央$和 省级|党报 党刊|订阅 任务
使 机关|党的 建设$在 思路上|有 新的 拓展
按照|分级 负责|归口 办理的 原则
德国 东部|和 北部$二十四日$遭|暴风雪 袭击
柏林 地区|二十四日|平均 降雪$大约|十五 厘米
有些 地方|积雪 厚达|六十 厘米
以色列|右翼 内阁 成员|强烈 抨击 佩雷斯
偿债 危机$是 阿根廷|金融 危机的 实质
只不过 是|捅破了 一层|窗户纸
国际上 早有 预言$阿根廷 即将|暂停 偿债
理论上 债权人|可以 扣押|阿根廷 政府的 资产
暂停 还债|省下的 钱$全部 用于|就业 计划$和|社会 救济
这样 就|澄清了 关于|汇率 政策 走向的|许多 猜测
他还 宣布$将 出售|全部 公家 汽车$和|政府的 飞机
只是|政治 方面的 形势$没有|经济 方面|那样 糟糕
萨阿的 任期$就是 一种|政治 折衷的 结果
而|这次 大选$将 采用|口号法
在|最短的 时间内$提出 报告
没想到 第三天$就被|保姆 抢走了|用来 治病的 钱
把 以往|到处 乱贴的 小广告$转移到 广告板上
重点 加强|劳务 报酬|财物 租赁 等项$所得的|核定 征税
在|限期 安装$和 使用|税控 加油机的 基础上
严格 执行$不认证$不抵扣的 规定
并与 专用 发票|发行|发售 系统 软件|相 整合
实现 对|增值税 发票$和 税款的|全面 监控
在场的人 都感到$此人的 容貌|与 毛泽东|确有 几分 相像
偏偏 用一个|长相|酷似 毛泽东的|人的 照片
画面上 却用|大字 题写着|毛家 两字
没有 侮辱|毛家 饭店的 内容
是 医院|传染病 研究所|副所长$成军的 研究 成果
为 研究|肝炎 病毒$引发 肝癌的 机理$开辟了 新方向
他 根据|传统 中医|天人 相应的|整体 观念$肾之 阴阳|平衡 理论
他们 总是 把|环境 污染的 成本$摊给 大众
实质上 就是|维护|个别 企业的 稳定
还是 纵容|污染 企业|得 人心呢
世界 各国的|经验 和|教训 证明
为什么 一些|政府 领导$偏偏|宽容 污染者
无非 是怕|下岗 职工 惹麻烦
实质上 是一种|安于 现状$息事 宁人的$求稳 怕乱 心态
中原 油田$东濮 凹陷 油气|地质 勘探$获|重大 成果
公安部 部长|贾春旺$作 道路 交通|安全法 草案的 说明
形成了 一批|新的 产业 支撑点$和|经济 增长点
金龙 公司 开发的$内螺纹|精密 铜管
宽阔 平坦的 公路$渐渐 变得|狭窄 颠簸
它是|魏庙 小学的 一间|办公室
是|上海市 普陀区$提前 退休的 女职工
但却是|截然 不同的|另外 一个 世界
一个 上海人|会从 这条 公路的|那一端$走到 这一端来
有一天 晚上$我在 梦里 看见了|您 和|全班 同学$在一起 做游戏
过去 我们|磨破 嘴皮子$也 没法|说服 乡亲
他们 说$每个人 出一元|也愿意
五十岁的 老党员|魏家民$一边说|一边 抽泣
也 不回去啊$她是 为了|我们的 孩子啊$我|这么大 年纪了
深受 影片|乡村 女教师 影响的|查文红
我 总觉得$自己 和|农村的 孩子$有|千丝 万缕的 联系
查文红 看到了 团中央|实施|希望 工程的$公益 广告
查文红 一家$向 希望 工程|寄去了$第一笔 款项
马小峰|和 妹妹 马小云|是一对 孤儿
尽管|她对 那里的 贫困$有着 充分的|心理 准备
但|面前的 景象$还是|让她 震惊
床上 用|晒干的 玉米皮|当 褥子
芦秆 编成的 墙上$贴满了 马小峰|和 妹妹的 奖状
比|城里 六十岁 老人的 手$还要 粗糙
愿意 到这里$做一个|不拿 一分钱的 教师
在 魏庙 小学$当了 一个 教师
有人说 她是|千万 分之一$一个 傻瓜
她 每天|都会 想起 上海的|翠滴滴的 青菜
她 丈夫|也是|提前 退休的 工人
这个 班|在 全县|十所 小学 统考中
要在|上海 这样的 城市$养活 一个家
查文红 脸上$也沾满了 泪水|和 鼻涕
我 总觉得$为他们|做得 太少
查文红 在 慢慢地$清晰地 体会着|自己的 心血$所带来的 收获
曹庄镇 党委书记$王金夯|告诉 记者
就在 查文红|那低矮的|四一班 教室 后面
图为 查文红$讲述 她 和|贫苦 地区|孩子们的 故事
事故 抢修$恢复 送电 时间$比|上年 缩短|一半 以上
该 单元|墙内 电线|曾经 着过火
按说|这个 事儿$本 不属于|电业 部门的|管辖 范围
耐心地|一条线 一条线 检查
而|李庆长 他们$只是 拿出|自带的 水|喝了 几口$就 上路了
李庆长 这仨字$已经 不属于 我|一个人 所有
做起|深化 创新|这篇 大文章
德州局 推出了|迎宾 服务 一窗通
围绕 羊绒$羊剪绒 毛毡|三个 传统 行业
以 华澳 皮毛|有限 责任 公司$为|生产 销售 龙头的|羊剪绒 生产
非公有制经济的 发展 兴衰$与|环境 优劣|密切 相关
严禁 对|个体 私营 企业$乱检查$乱收费$乱罚款
为|非公有制经济 发展$创造了 良好的|硬环境
公司 以|自有的 一百亩|示范 育种 基地|为 基础
淠史 杭灌区$之所以|闻名 世界
就是|淠史 杭灌区$众多|治水 英雄中的 一员
地处|安徽省 舒城县的|龙河口 水库 上马
正在|龙河口 水库 建设$热火 朝天的 时候
为了|养活 这个|先天 不足的 女儿
现在$许芳华 不得 不到|县城里|给人 帮工
虽然|淠史 杭灌区|建设 奇迹$依旧 辉煌
依稀 可见|当年的 造湖者$在 岩壁上|雕刻的 期盼
包括|内蒙古 赤峰市$和 锡林郭勒 盟旗县的|浑善达克 沙地
人们|眼睁睁 看它|变成了 八百里 瀚海
这是 赤峰市|沙化 最严重的 旗
今年 四月|新任命的 市委书记$罗啸天 说
草场 退化|沙化 面积$一百 多万亩
年|风沙 埋没|刚通车的$京通 铁路|敖 汉段
两年后|科尔沁 沙地$将 袭击 京津|吞并 沈阳
京津 冀晋|内蒙古 省市区$提前 被|沙害 危及
最早 意识$并投身|恢复 生态的 战斗
四周 万亩|无人 无畜区$枯草 足有 没膝深
而|村前 屋后$光光的 白沙土|寸草 不生
迷恋地 称这里 是|法国的 庄园
像|敖汉 那样|重在 建设$植树 造林的|动人 故事|说不完
书记 罗啸天$和|市长 呼尔查$号召 各级 干部
风沙 源治理$提倡|建设 保护 并举
去年初$旗政府 就|下达了 禁牧令$禁牧区 管理 办法
一是 打击|以 虚开 增值税|专用 发票|为 重点的$各类 偷税 行为
正在 扎染|和 刺绣的|苗族 老太太$和 她的 孙女
一位|黎族 小伙$表演|爬树 摘椰子
农村 劳动力$及其 家庭$进入 大中城市$工作 和|定居的 机会
我国|现代化的 关键$是|能否 加快|城市化 进程
但 改了 之后$是否 问题 就|迎刃 而解了
而 大中城市的|生活 成本|相对 较高$进入的 门槛高
与|本地区 居民 一样的|子女 教育费$和 公费 医疗
每年的 六月份$在|青岛市 举行
共获得了|五个 项目中的|三块 金牌
也是|第一阶段 小组赛$倒数 第二轮的 比赛
而 北京队 和|浙江队$则|不得 不为 保级$苦苦 挣扎了
泰国 选手|帕拉敦 诗里查攀$获得|男子 单打 冠军
诗里查攀 今天 在|决赛中$控制了 主动权
击败|亚洲 头号 选手$韩国的 李亨泽
国内|自行车 爱好者$将 有机会|一睹 世界|一流 车手的 风采
实德队 主教练|科萨诺维奇 认为
不时 可以 听到|少数 球迷|粗俗的 京骂
有|和缓 势头$减缓 交流|与 合作 步伐|放慢的 迹象
尽管|韩朝 首脑$签署了 北南|共同 宣言
金大中的|对朝 政策$受到 在野党|多方 牵制
布什 政府$对朝 态度 强硬$是 影响|韩朝 关系 发展的$重要 因素
缓和|紧张 局势$是|大势 所趋
俄 有望|重新 成为 一个$对 国际 事务|拥有|巨大 影响力的 强国
也就|米切尔 报告$和|特尼特 建议|达成过 协议
双方的 敌对$转而|占了 上风
继续在$报复 与|反报复的|恶性 循环中 兜圈子
一是|今年 三月$沙龙 当总理后$采取|更强硬的 立场
激发了 巴勒斯坦$和 整个 阿拉伯 世界$反美 反以|情绪的 高涨
鼓动 暴力|和 滥用 暴力$均无 出路
百分之百的 努力$不一定 有|百分之百的 成果
世界 还是 朝着|和平 与|发展 前进
世界 主要 国家|和 国家 集团$依然 为|军事 威胁|所 困扰
尽管|当前 国家 行为体$仍是|国际 关系的 主体
事件 暴露了|美国 软国力的 弱点
所有 这些$都 增加了|国际 安全 环境的|曲折性$和 复杂性
如若|高科技 成为|恐怖主义 和|霸权主义的 利器
寻梦的 中国人$将在|圆梦的 大道上$坚定 前行
在 北京师范大学$喜迎 百年|校庆 之际
为什么 会变成|残杀 自己|亲人的 恶魔
邪教 法轮功的|歪理 邪说$控制了 痴迷者的|思想 意识
他们 把|杀害 亲人|毁灭 家庭 等等$大逆 不道$惨无 人道的 行径
甚至 像|傅怡彬 那样$灭绝 人性地|残杀 自己的|父母 和 妻子
有的 痴迷者|因练 法轮功$而 远离了|正常人的 生活
正在 走进|阴森 恐怖的|天国 世界
生活中$还不知 会出现|多少 类似|傅怡彬$杀害 亲人的 悲剧
为了 挽救|受骗 上当$处于 危险 境地的|法轮功 痴迷者
他们|祸国 殃民的|贼心 不死
我们 要有|足够|和 清醒的 认识
这是|广西 残联 理事长|李小凤$给|残疾 儿童|送 温暖
他们 实行|开卷 考试$与|闭卷 考试|相 结合
他 带领|乡亲们$由 两挂 马车|跑 运输 起家
毕业于$德国 慕尼黑|电影 学院
与|萧三 结婚$并 加入|苏联 国籍
八十岁 高龄的|叶华$在北京|中国 美术馆$举办了 名为|中国
沉没 地点$在|中国 领海外$约|一千 公里处
肇庆市$制定了|一手 抓|中心区 发展
山西省委 书记|田成平$两次 就|人民日报 发行|作出 批示
省委 副书记|侯伍杰$也作出 批示
晋中 市委 书记|刘俊谦$亲自 抓|发行 工作
把|生产 用具$和 生活 用品|藏起来
当 他们|躲在 山上$看到 解放军|秋毫 无犯
帮 他们|修桥 铺路$收割 青稞时
蹲点 干部$到|农民 炕头$地头$与 群众 拉家常
人民群众$总是 通过|具体 事情$来 观察|评判 干部的
也是|全国 广大|妇女 工作者|学习的 榜样
俄|希望 美国|恪守 自己的 诺言
圆明园|驻园 单位|忙 搬迁
长期 驻扎在|圆明园的 单位$忙着 挪窝
正觉寺内的$八角楼$被 腾出来
该省|建设 部门$名义上 减少了|燃气 锅炉的 审批权
实际上|却把 这一 权限$下放 到了|该协会
日前|吉林省 长春市$又发生 一起|环卫 工人|遭伤害 事件
她们|正在 大街上|清扫 积雪
依然是|困扰 我们的$尴尬 之一
从|义务 献血$指令性 计划 献血$到|自愿 无偿 献血
一股股|浸透 爱心的|涓涓 血流
为 保证|事故|抢修的 及时性
开展了$保护|电力 设施$和 反窃电|集中 整治 行动
对$办事 效率|和|服务 态度的 评价
这是|该局 举办的$买电炊$赠电量|演示会 一角
电力 企业|为|客户 服务$算是 做到 家了
建立起 一套|灵活$方便 高效的|现代 服务 体系
全镇 滑子蘑|接种量$为 万盘
石灰窑|全镇 农民$人均 可增收|十元
笔者 在|江西省 九江县$经过|入户 调查 摸底
全市|街头 采血量$继续 稳定在|一千 毫升 左右
谢谢 哈尔滨人|送来 救命血
又一次|严重的 血荒$降临 哈尔滨
哈尔滨市的|无偿 献血 工作$为什么 能发生|如此|巨大的 变化
这是 上海港|进出 长江的$第二条 通道
记者 来到|坐落在 长白山麓$吉林市 永吉县的|天三奇 集团
两千年夏$因患 类风湿|瘫痪 辍学
其 母亲|给他 治病$把 耕牛 卖了
他 让人|给 孟灵权$送去 公司|新研制的 药品
因|家庭 成分 不好$及|经济等 原因
今后$凡是 像 孟灵权|这样的 学生
主动 寻找 那些$因患 肠胃 风湿|和 类风湿 疾病|而|辍学的 孩子
一封|又 一封的|赞扬 感谢信$飞向 这里
在|花瓶的 一侧$我们 看到|孩子的 来信
是您|金子般 爱心$给了我|新的 希望
好像|驶进了 一条$没有 航标的 河道
还会$助长|日本 企业的 惰性
在 当前|全球 经济|放缓的 大背景下
维护了|国际 收支 平衡$和 人民币|汇率 稳定
用|行政 手段$颇有点|逼农 致富的 味道$大面积 推广|一种 柿子
某某 建材|批发 市场|圈起来的地$一直在 晒太阳
其中 成交额|超亿元的$有 六个
横店|过去 是个|交通 闭塞$名不见经传的 小镇
鸦片 战争|等一批 大片$都是 在那儿 拍的
不是说|搞 市场经济$就不需要 政府 这只|看得见的 手了
而|切不可 跟|运动员$角色 错位
还|涌现出了 一大批|实力 雄厚的|文化 企业
三峡|枢纽 工程$分|三期 施工
首台 机组|重达 十吨的|发电机 定子
稳稳地 吊放到|直径|一千 多米的 机坑内
上游 围堰$七月 四日|开始 拆除
其中|部分 石块$将在|三期 工程|大江 截流时|抛投用
三峡|枢纽 工程|二期|土建 工程$已|基本 完工
一位|姓戴的 移民$对 现在的 新居|十分 满意
还 组织 鼓励|名优 企业$到库区|结对子 搞合作
这样|也可以 减轻$库区 土地|开发的 压力
这里的 城镇$在|基础 设施 方面$也|颇多 空白
今年|国家 又给|重庆 湖北 两地$下达 经费|十多 万元
新增 费用$可以 从|概算内$预留 项目中 支出
故|无暇 再为|友好 运动会$投入 冤枉钱
新浪狮$主场 击败 弱旅|深圳 易康
回到 主场的|山东 金斯顿|抖擞 精神
人民网|体育 在线$仍将 对 比赛|进行|网上 直播
王励勤 加强了|发球 抢攻$并在|第二局 胜出
第四盘$王励勤 以|三比二$战胜了 卡尔松
欧盟 在|极短 时间内$召开了|特别 首脑 会议
但|今年 在|外交 方面的 表现$很 惹眼
这 其中 有|客观 条件的 促成
日政府 同意|台独分子的 总后台|李登辉$赴日 治病
日本 海上 自卫队$三艘 军舰|驶往 印度洋
这一|军事 行动$引起 亚太|许多 国家的 担忧|和 疑虑
布什 政府的|外交 特征$可 概括为
指的是|战争 爆发的|燃点 升高
美|在 该地区的|军事 展开$和 外交上的|合纵 连横
暴力 冲突的|升级$预示着 巴以$和|阿以 矛盾$更难 解决
以及 日本|和 西欧等|发达 地区$经济的 乏力
削弱了|消费者 与|投资者的 信心|和 预期
给|今后 一段 时期$各国 各地区的 发展|或 复苏$留下|些许 阴影
也从|一个 侧面$揭示了|国际 社会|既有|治理 方式的 缺失
作为 国际上|最富|道义 威信的 组织
应验了|不经历 风雨$怎么见 彩虹的 歌词
更提示|国际 社会$关注|现有 体制的|缺陷 与 矛盾
无形中 使得|平等 协商|和平 共处的|新安全观$得到 强化
将 带动|昌平 经济|结构 调整
傅怡彬 是从|电视上 得知$他母亲 没有 被|砍死的 消息的
断了气$就 不要 受|那些 罪了
他 清楚地 记得$是一个 叫|杨翠云的 人 介绍他 练法轮功的
杨翠云|在 两年 以前$曾经|练过 法轮功
你|可以 来看看|李洪志|讲法的 录像
觉得|找到了 一条|修炼的 正路
有个 练功点$离 我们家 不远
我 连续|三天 晚上$看 李洪志|说法的 录像
就会 觉得$这个 世界|太肮脏了
就会 出现|自残$自杀$杀人 等|极端 行为
把|杀害 亲人$作为|最大的 善事
李慧云 有一个|聪明 可爱的 儿子
她曾 多次 处于|恍惚$不安的 状态
当时 沉迷于|李洪志$圆满 憧憬中的|李慧云 认为
是把他|带入 天国 世界$我|第一个 想度的$就是 儿子
第一个 感觉|就是想|痛哭 一场
醒悟 过来的 邢潇$痛心 疾首
我们|辛辛 苦苦地|教育了 你 十年
最常用的|催眠 方法$是|长时间的$反复的$单调的 刺激
大脑 皮层$只对 经文|保持 强烈的|清醒 兴奋 状态
李洪志的|升天 圆满等|歪理 邪说$就在|反复 单调的 刺激下
是从|地球 这座|宇宙的 垃圾站$脱离开
为 缓解 我国|软件 人才|匮乏的 问题$提供 一条|有价值的 途径
它们 像|一颗颗 闪亮的 明珠$镶嵌在|大江 南北
缔造|生产 发达|生活 富裕$生态 良好的|新文明的 轨迹
环境 保护|只有 投入|没有 产出的 说法$不攻 自破
要不$咱咋会 走上|致富路呀
以 排忧 解难的|实际 行动$取信于民
王辇庄乡|西赵各庄村$是|蔬菜 专业村
卖方 与 报价|最高的 买方 成交
这次 订货会$采用 网上|公开 竞卖的 新方式
今年 前两个月$港口 吞吐量|创纪录
适应了 西部|进出口 货物$快进 快出|快装 快卸的 需要
并给|小企业的 发展$创造|有利 环境
可能使 我国|粮食|和 棉花 价格$在 国际 市场的|压力下 走低
预计 将 减少|几百万个|就业 机会
即|大量 人员|失业$与 许多 岗位|招不到|合格 劳动者 并存
举办 有关|信用 道德 问题的|征文 演讲 比赛$十多场次
营造了|诚实 守信的|良好 氛围
建成 两侧 各|十米宽$总长 一百公里的|绿色 长廊
初步 形成了|三处|万亩以上的|绿色 大板块
自治区 党委书记|储波$要求|各盟 市委|一把手 负责
保证有|个人 创造性$和|个人 爱好的|广阔 天地
零票 反对$和 三票 弃权的|投票 结果
巴方 有两名|当地的 平民$被 印军|炮火 击伤
阿拉法特$坚持 参加|圣诞 弥撒
鸽子|大快 朵颐后$出现|消化 不良
扰乱了 正常的|社会 救助 秩序
制糖 行业|本榨季$产量|同比 减少
十户 糖精厂中$需要|关闭 转产的 七户$已 全面 完成|关闭 转产
已列入|破产 方案的 糖厂$必须|彻底 关闭
进一步 加大 反腐败|抓源头 工作 力度
允许 本人|及其 配偶|未成年 子女$在 城市 登记|常住 户口
关系|党 和 国家的|生死 存亡
归结到|关心 群众 疾苦$全心 全意|为人民 服务 上来
把 群众的|安危 冷暖$时刻 放在 心上
我们党|对 扶贫 开发的|高瞻远瞩
努力|开创 我国|扶贫 开发 工作的|新局面
帮助 贫困 群众$破除|封闭 落后的|旧思想$旧观念$旧习俗
